id,Natural_score,Economical_score,Security_score,Total_score,county_name,state_id,state
29510,107,207,0,314,St. Louis city,29, MO
5035,77,201,0,278,Crittenden County,5, AR
17003,186,234,0,420,Alexander County,17, IL
48261,231,73,0,304,Kenedy County,48, TX
22031,159,162,0,321,De Soto Parish,22, LA
24510,113,215,0,328,Baltimore city,24, MD
47157,109,233,1,343,Shelby County,47, TN
45069,153,234,1,388,Marlboro County,45, SC
32029,246,201,1,448,Storey County,32, NV
11001,92,190,1,283,District of Columbia,11, DC
45033,97,106,1,204,Dillon County,45, SC
29201,62,67,1,130,Scott County,29, MO
42101,108,250,1,359,Philadelphia County,42, PA
32027,240,50,1,291,Pershing County,32, NV
45047,129,120,1,250,Greenwood County,45, SC
47113,62,170,1,233,Madison County,47, TN
47037,157,190,1,348,Davidson County,47, TN
18097,26,186,1,213,Marion County,18, IN
26163,51,253,2,306,Wayne County,26, MI
29095,60,153,2,215,Jackson County,29, MO
2188,0,249,2,251,Northwest Arctic Borough,2, AK
29155,73,190,2,265,Pemiscot County,29, MO
22047,103,234,2,339,Iberville Parish,22, LA
5119,182,166,2,350,Pulaski County,5, AR
5069,76,190,2,268,Jefferson County,5, AR
5091,118,144,2,264,Miller County,5, AR
40101,164,101,2,267,Muskogee County,40, OK
45011,123,166,2,291,Barnwell County,45, SC
22105,119,229,2,350,Tangipahoa Parish,22, LA
45067,127,181,2,310,Marion County,45, SC
2070,0,197,3,200,Dillingham Census Area,2, AK
13095,117,209,3,329,Dougherty County,13, GA
40019,194,149,3,346,Carter County,40, OK
26049,46,246,3,295,Genesee County,26, MI
1087,103,231,3,337,Macon County,1, AL
55079,111,197,3,311,Milwaukee County,55, WI
45079,170,91,3,264,Richland County,45, SC
47061,138,234,3,375,Grundy County,47, TN
1063,134,245,3,382,Greene County,1, AL
27133,2,8,3,13,Rock County,27, MN
6077,243,247,3,493,San Joaquin County,6, CA
19155,79,63,3,145,Pottawattamie County,19, IA
48353,218,67,4,289,Nolan County,48, TX
2150,0,110,4,114,Kodiak Island Borough,2, AK
17201,27,247,4,278,Winnebago County,17, IL
25025,181,233,4,418,Suffolk County,25, MA
26145,11,236,4,251,Saginaw County,26, MI
1047,125,243,4,372,Dallas County,1, AL
13121,121,190,4,315,Fulton County,13, GA
2020,0,166,4,170,Anchorage Municipality,2, AK
12079,199,101,4,304,Madison County,12, FL
5107,97,221,4,322,Phillips County,5, AR
17167,28,197,4,229,Sangamon County,17, IL
47075,52,218,4,274,Haywood County,47, TN
39095,87,241,5,333,Lucas County,39, OH
37155,59,215,5,279,Robeson County,37, NC
20119,126,6,5,137,Meade County,20, KS
12033,222,135,5,362,Escambia County,12, FL
1073,168,110,5,283,Jefferson County,1, AL
54067,138,240,5,383,Nicholas County,54, WV
12037,227,73,5,305,Franklin County,12, FL
17163,49,220,5,274,St. Clair County,17, IL
22071,145,250,5,400,Orleans Parish,22, LA
48135,225,245,5,475,Ector County,48, TX
22009,106,190,5,301,Avoyelles Parish,22, LA
22079,123,110,5,238,Rapides Parish,22, LA
45085,164,140,6,310,Sumter County,45, SC
40031,221,135,6,362,Comanche County,40, OK
5093,50,220,6,276,Mississippi County,5, AR
45029,175,106,6,287,Colleton County,45, SC
6049,245,207,6,458,Modoc County,6, CA
6001,246,215,6,467,Alameda County,6, CA
13261,150,166,6,322,Sumter County,13, GA
45031,154,126,6,286,Darlington County,45, SC
22081,192,110,6,308,Red River Parish,22, LA
48303,193,87,6,286,Lubbock County,48, TX
35053,231,153,6,390,Socorro County,35, NM
48131,187,250,6,443,Duval County,48, TX
35001,237,194,7,438,Bernalillo County,35, NM
48315,203,197,7,407,Marion County,48, TX
45061,80,174,7,261,Lee County,45, SC
6089,249,212,7,468,Shasta County,6, CA
45059,114,144,7,265,Laurens County,45, SC
2185,0,96,7,103,North Slope Borough,2, AK
28049,71,225,7,303,Hinds County,28, MS
35006,230,223,7,460,Cibola County,35, NM
40143,118,131,7,256,Tulsa County,40, OK
12107,222,186,7,415,Putnam County,12, FL
48245,189,249,7,445,Jefferson County,48, TX
54069,128,205,7,340,Ohio County,54, WV
6075,255,181,8,444,San Francisco County,6, CA
45009,93,220,8,321,Bamberg County,45, SC
6047,242,250,8,500,Merced County,6, CA
48201,134,218,8,360,Harris County,48, TX
48249,205,252,8,465,Jim Wells County,48, TX
40109,151,120,8,279,Oklahoma County,40, OK
35031,234,240,8,482,McKinley County,35, NM
29133,65,67,8,140,Mississippi County,29, MO
6003,253,246,8,507,Alpine County,6, CA
13037,148,58,8,214,Calhoun County,13, GA
47045,112,190,8,310,Dyer County,47, TN
32003,244,253,8,505,Clark County,32, NV
35019,227,135,9,371,Guadalupe County,35, NM
35045,228,237,9,474,San Juan County,35, NM
45039,175,186,9,370,Fairfield County,45, SC
29119,124,54,9,187,McDonald County,29, MO
12123,222,110,9,341,Taylor County,12, FL
13305,128,83,9,220,Wayne County,13, GA
22033,94,181,9,284,East Baton Rouge Parish,22, LA
12073,211,91,9,311,Leon County,12, FL
32015,236,46,9,291,Lander County,32, NV
12095,229,242,9,480,Orange County,12, FL
28083,64,243,9,316,Leflore County,28, MS
34013,135,249,9,393,Essex County,34, NJ
13225,98,110,10,218,Peach County,13, GA
13033,92,158,10,260,Burke County,13, GA
47065,194,153,10,357,Hamilton County,47, TN
12086,0,190,10,200,Miami-Dade County,12, FL
12023,171,91,10,272,Columbia County,12, FL
47033,37,96,10,143,Crockett County,47, TN
37107,52,110,10,172,Lenoir County,37, NC
5057,98,63,10,171,Hempstead County,5, AR
48233,214,158,10,382,Hutchinson County,48, TX
51760,84,215,10,309,Richmond city,51, VA
28065,75,231,10,316,Jefferson Davis County,28, MS
1035,80,162,10,252,Conecuh County,1, AL
22067,48,234,11,293,Morehouse Parish,22, LA
13099,146,91,11,248,Early County,13, GA
47077,181,190,11,382,Henderson County,47, TN
36085,150,242,11,403,Richmond County,36, NY
36061,117,229,11,357,New York County,36, NY
17081,51,237,11,299,Jefferson County,17, IL
36005,189,254,11,454,Bronx County,36, NY
36081,137,251,11,399,Queens County,36, NY
36047,126,251,11,388,Kings County,36, NY
13301,189,140,11,340,Warren County,13, GA
37127,65,205,11,281,Nash County,37, NC
47097,140,223,11,374,Lauderdale County,47, TN
47029,200,239,12,451,Cocke County,47, TN
48037,180,166,12,358,Bowie County,48, TX
45049,96,54,12,162,Hampton County,45, SC
12051,240,194,12,446,Hendry County,12, FL
12031,221,135,12,368,Duval County,12, FL
37063,120,126,12,258,Durham County,37, NC
29077,172,67,12,251,Greene County,29, MO
12065,216,83,12,311,Jefferson County,12, FL
1053,135,101,12,248,Escambia County,1, AL
45051,184,209,12,405,Horry County,45, SC
48355,233,220,12,465,Nueces County,48, TX
20173,96,212,12,320,Sedgwick County,20, KS
37065,39,242,13,294,Edgecombe County,37, NC
20125,90,162,13,265,Montgomery County,20, KS
22017,174,220,13,407,Caddo Parish,22, LA
4009,247,116,13,376,Graham County,4, AZ
6039,250,244,13,507,Madera County,6, CA
5131,191,101,13,305,Sebastian County,5, AR
13107,126,153,13,292,Emanuel County,13, GA
34007,73,237,13,323,Camden County,34, NJ
32023,245,233,13,491,Nye County,32, NV
4011,247,78,13,338,Greenlee County,4, AZ
12001,224,73,13,310,Alachua County,12, FL
5139,106,201,13,320,Union County,5, AR
17143,30,241,14,285,Peoria County,17, IL
1089,69,40,14,123,Madison County,1, AL
26025,21,233,14,268,Calhoun County,26, MI
45089,86,194,14,294,Williamsburg County,45, SC
48393,110,40,14,164,Roberts County,48, TX
47011,126,131,14,271,Bradley County,47, TN
45007,177,96,14,287,Anderson County,45, SC
8031,229,197,14,440,Denver County,8, CO
45023,134,218,14,366,Chester County,45, SC
1085,110,252,14,376,Lowndes County,1, AL
48489,213,249,14,476,Willacy County,48, TX
17031,78,246,14,338,Cook County,17, IL
18019,27,158,15,200,Clark County,18, IN
13089,118,190,15,323,DeKalb County,13, GA
48375,226,78,15,319,Potter County,48, TX
5001,87,24,15,126,Arkansas County,5, AR
5017,108,240,15,363,Chicot County,5, AR
4003,252,149,15,416,Cochise County,4, AZ
20209,126,181,15,322,Wyandotte County,20, KS
13287,143,158,15,316,Turner County,13, GA
6033,252,231,15,498,Lake County,6, CA
35029,228,254,15,497,Luna County,35, NM
12081,243,140,15,398,Manatee County,12, FL
25013,131,241,15,387,Hampden County,25, MA
13143,112,96,16,224,Haralson County,13, GA
10003,137,177,16,330,New Castle County,10, DE
1015,149,153,16,318,Calhoun County,1, AL
17077,177,177,16,370,Jackson County,17, IL
22093,74,233,16,323,St. James Parish,22, LA
47163,198,158,16,372,Sullivan County,47, TN
45045,213,87,16,316,Greenville County,45, SC
22029,125,194,16,335,Concordia Parish,22, LA
21111,156,140,16,312,Jefferson County,21, KY
6029,243,251,16,510,Kern County,6, CA
13063,117,240,16,373,Clayton County,13, GA
6063,252,243,16,511,Plumas County,6, CA
51595,91,246,17,354,Emporia city,51, VA
45055,153,67,17,237,Kershaw County,45, SC
26107,45,221,17,283,Mecosta County,26, MI
22069,161,140,17,318,Natchitoches Parish,22, LA
35015,245,144,17,406,Eddy County,35, NM
45087,90,220,17,327,Union County,45, SC
22123,21,237,17,275,West Carroll Parish,22, LA
17183,13,215,17,245,Vermilion County,17, IL
35039,247,194,17,458,Rio Arriba County,35, NM
37051,95,229,17,341,Cumberland County,37, NC
47069,77,197,17,291,Hardeman County,47, TN
5063,142,91,17,250,Independence County,5, AR
22101,182,223,18,423,St. Mary Parish,22, LA
1017,115,140,18,273,Chambers County,1, AL
6103,232,215,18,465,Tehama County,6, CA
13027,158,63,18,239,Brooks County,13, GA
17019,1,120,18,139,Champaign County,17, IL
13127,218,140,18,376,Glynn County,13, GA
51730,67,253,18,338,Petersburg city,51, VA
51710,166,212,18,396,Norfolk city,51, VA
17071,68,144,18,230,Henderson County,17, IL
6091,250,190,18,458,Sierra County,6, CA
22035,70,249,18,337,East Carroll Parish,22, LA
47025,208,149,18,375,Claiborne County,47, TN
37119,181,181,19,381,Mecklenburg County,37, NC
6015,255,229,19,503,Del Norte County,6, CA
24033,100,197,19,316,Prince George's County,24, MD
22055,28,153,19,200,Lafayette Parish,22, LA
29023,88,116,19,223,Butler County,29, MO
1119,107,149,19,275,Sumter County,1, AL
47119,125,194,19,338,Maury County,47, TN
1097,206,186,19,411,Mobile County,1, AL
22097,95,212,19,326,St. Landry Parish,22, LA
34011,160,244,19,423,Cumberland County,34, NJ
13277,157,58,19,234,Tift County,13, GA
12103,245,149,19,413,Pinellas County,12, FL
51770,137,177,20,334,Roanoke city,51, VA
45027,193,140,20,353,Clarendon County,45, SC
35005,238,194,20,452,Chaves County,35, NM
13239,190,126,20,336,Quitman County,13, GA
24045,96,170,20,286,Wicomico County,24, MD
6067,236,225,20,481,Sacramento County,6, CA
48003,176,197,20,393,Andrews County,48, TX
6099,253,243,20,516,Stanislaus County,6, CA
13255,116,174,20,310,Spalding County,13, GA
48469,89,201,20,310,Victoria County,48, TX
5123,68,186,20,274,St. Francis County,5, AR
54105,115,243,20,378,Wirt County,54, WV
37083,68,223,21,312,Halifax County,37, NC
13161,101,58,21,180,Jeff Davis County,13, GA
24015,143,96,21,260,Cecil County,24, MD
12009,238,131,21,390,Brevard County,12, FL
1013,73,215,21,309,Butler County,1, AL
47125,106,174,21,301,Montgomery County,47, TN
45013,209,73,21,303,Beaufort County,45, SC
37067,77,166,21,264,Forsyth County,37, NC
6019,250,247,21,518,Fresno County,6, CA
10001,132,209,21,362,Kent County,10, DE
48227,220,194,21,435,Howard County,48, TX
13237,222,131,21,374,Putnam County,13, GA
29141,196,116,22,334,Morgan County,29, MO
37007,140,177,22,339,Anson County,37, NC
39003,31,207,22,260,Allen County,39, OH
13065,156,24,22,202,Clinch County,13, GA
13317,174,135,22,331,Wilkes County,13, GA
26121,111,247,22,380,Muskegon County,26, MI
54043,77,237,22,336,Lincoln County,54, WV
12039,209,140,22,371,Gadsden County,12, FL
1011,76,78,22,176,Bullock County,1, AL
42043,191,215,22,428,Dauphin County,42, PA
30041,71,54,22,147,Hill County,30, MT
13021,212,170,22,404,Bibb County,13, GA
47093,172,96,23,291,Knox County,47, TN
37181,140,237,23,400,Vance County,37, NC
40013,217,58,23,298,Bryan County,40, OK
39035,99,241,23,363,Cuyahoga County,39, OH
29213,209,252,23,484,Taney County,29, MO
37117,18,144,23,185,Martin County,37, NC
47107,114,181,23,318,McMinn County,47, TN
5039,48,67,23,138,Dallas County,5, AR
42045,96,221,23,340,Delaware County,42, PA
48475,205,227,23,455,Ward County,48, TX
47053,47,149,23,219,Gibson County,47, TN
25005,169,239,23,431,Bristol County,25, MA
45073,235,73,24,332,Oconee County,45, SC
1055,187,177,24,388,Etowah County,1, AL
40123,189,63,24,276,Pontotoc County,40, OK
12087,250,186,24,460,Monroe County,12, FL
48177,176,73,24,273,Gonzales County,48, TX
45001,100,131,24,255,Abbeville County,45, SC
51640,175,177,24,376,Galax city,51, VA
24019,148,135,24,307,Dorchester County,24, MD
42073,151,240,24,415,Lawrence County,42, PA
13017,130,144,24,298,Ben Hill County,13, GA
6031,235,248,24,507,Kings County,6, CA
24005,113,140,24,277,Baltimore County,24, MD
19057,42,170,25,237,Des Moines County,19, IA
12093,243,73,25,341,Okeechobee County,12, FL
45057,142,144,25,311,Lancaster County,45, SC
19111,45,126,25,196,Lee County,19, IA
22019,97,220,25,342,Calcasieu Parish,22, LA
48381,223,37,25,285,Randall County,48, TX
22089,130,181,25,336,St. Charles Parish,22, LA
13009,218,144,25,387,Baldwin County,13, GA
8101,218,197,25,440,Pueblo County,8, CO
48073,197,186,25,408,Cherokee County,48, TX
47109,53,212,25,290,McNairy County,47, TN
35025,212,245,25,482,Lea County,35, NM
1059,146,33,26,205,Franklin County,1, AL
20061,161,144,26,331,Geary County,20, KS
1123,219,144,26,389,Tallapoosa County,1, AL
48123,167,101,26,294,DeWitt County,48, TX
12005,219,106,26,351,Bay County,12, FL
37165,96,249,26,371,Scotland County,37, NC
22091,43,248,26,317,St. Helena Parish,22, LA
22117,57,197,26,280,Washington Parish,22, LA
48057,213,91,26,330,Calhoun County,48, TX
47091,178,126,26,330,Johnson County,47, TN
35061,230,197,26,453,Valencia County,35, NM
48183,148,201,26,375,Gregg County,48, TX
48273,231,205,27,463,Kleberg County,48, TX
30091,40,46,27,113,Sheridan County,30, MT
13215,142,181,27,350,Muscogee County,13, GA
25019,229,240,27,496,Nantucket County,25, MA
47039,157,209,27,393,Decatur County,47, TN
12097,242,252,27,521,Osceola County,12, FL
45091,164,106,27,297,York County,45, SC
20177,50,96,27,173,Shawnee County,20, KS
46103,198,67,27,292,Pennington County,46, SD
26065,10,170,27,207,Ingham County,26, MI
20029,60,27,27,114,Cloud County,20, KS
12007,201,96,27,324,Bradford County,12, FL
31055,45,58,28,131,Douglas County,31, NE
1033,176,131,28,335,Colbert County,1, AL
34031,199,251,28,478,Passaic County,34, NJ
48179,180,194,28,402,Gray County,48, TX
51740,166,231,28,425,Portsmouth city,51, VA
1099,198,197,28,423,Monroe County,1, AL
35059,188,58,28,274,Union County,35, NM
47071,163,153,28,344,Hardin County,47, TN
1025,197,220,28,445,Clarke County,1, AL
22077,146,181,28,355,Pointe Coupee Parish,22, LA
1041,85,87,28,200,Crenshaw County,1, AL
12083,225,149,28,402,Marion County,12, FL
12099,246,174,29,449,Palm Beach County,12, FL
4019,239,177,29,445,Pima County,4, AZ
41051,241,209,29,479,Multnomah County,41, OR
45043,206,170,29,405,Georgetown County,45, SC
45025,112,106,29,247,Chesterfield County,45, SC
13081,158,186,29,373,Crisp County,13, GA
40125,153,106,29,288,Pottawatomie County,40, OK
35011,234,50,29,313,De Baca County,35, NM
45017,148,106,29,283,Calhoun County,45, SC
51750,153,116,29,298,Radford city,51, VA
12011,245,215,29,489,Broward County,12, FL
54081,128,218,29,375,Raleigh County,54, WV
35047,237,201,30,468,San Miguel County,35, NM
19139,31,101,30,162,Muscatine County,19, IA
48127,166,120,30,316,Dimmit County,48, TX
47103,72,209,30,311,Lincoln County,47, TN
12091,217,78,30,325,Okaloosa County,12, FL
20155,110,78,30,218,Reno County,20, KS
13087,189,46,30,265,Decatur County,13, GA
47063,206,153,30,389,Hamblen County,47, TN
40089,218,131,30,379,McCurtain County,40, OK
27123,41,144,30,215,Ramsey County,27, MN
6107,249,252,30,531,Tulare County,6, CA
22073,168,166,30,364,Ouachita Parish,22, LA
1091,94,110,31,235,Marengo County,1, AL
54027,176,78,31,285,Hampshire County,54, WV
19045,33,135,31,199,Clinton County,19, IA
13013,96,58,31,185,Barrow County,13, GA
36029,96,229,31,356,Erie County,36, NY
47031,86,181,31,298,Coffee County,47, TN
37153,184,223,31,438,Richmond County,37, NC
20011,48,83,31,162,Bourbon County,20, KS
34001,134,255,31,420,Atlantic County,34, NJ
32033,230,29,31,290,White Pine County,32, NV
10005,140,170,31,341,Sussex County,10, DE
54039,128,218,31,377,Kanawha County,54, WV
47121,199,209,32,440,Meigs County,47, TN
13245,138,174,32,344,Richmond County,13, GA
29093,180,149,32,361,Iron County,29, MO
45071,147,46,32,225,Newberry County,45, SC
48343,162,247,32,441,Morris County,48, TX
45041,103,83,32,218,Florence County,45, SC
48231,190,126,32,348,Hunt County,48, TX
35041,204,110,32,346,Roosevelt County,35, NM
22027,142,131,32,305,Claiborne Parish,22, LA
40017,130,101,32,263,Canadian County,40, OK
36093,41,194,32,267,Schenectady County,36, NY
48291,142,242,32,416,Liberty County,48, TX
1113,121,58,33,212,Russell County,1, AL
6027,252,181,33,466,Inyo County,6, CA
45081,138,31,33,202,Saluda County,45, SC
29109,28,106,33,167,Lawrence County,29, MO
51540,135,120,33,288,Charlottesville city,51, VA
39061,65,181,33,279,Hamilton County,39, OH
6037,255,251,33,539,Los Angeles County,6, CA
34021,90,166,33,289,Mercer County,34, NJ
47149,88,144,33,265,Rutherford County,47, TN
1127,168,91,33,292,Walker County,1, AL
20103,114,91,33,238,Leavenworth County,20, KS
19163,31,140,33,204,Scott County,19, IA
29015,205,162,34,401,Benton County,29, MO
47141,151,131,34,316,Putnam County,47, TN
48113,174,177,34,385,Dallas County,48, TX
24003,177,91,34,302,Anne Arundel County,24, MD
37081,88,209,34,331,Guilford County,37, NC
55051,96,246,34,376,Iron County,55, WI
34017,166,242,34,442,Hudson County,34, NJ
22051,147,225,34,406,Jefferson Parish,22, LA
28043,212,158,34,404,Grenada County,28, MS
22025,142,153,34,329,Catahoula Parish,22, LA
39049,29,166,34,229,Franklin County,39, OH
37001,82,158,34,274,Alamance County,37, NC
22065,97,205,35,337,Madison Parish,22, LA
12045,220,96,35,351,Gulf County,12, FL
47123,206,190,35,431,Monroe County,47, TN
54083,56,223,35,314,Randolph County,54, WV
6053,254,244,35,533,Monterey County,6, CA
5143,196,40,35,271,Washington County,5, AR
29105,129,201,35,365,Laclede County,29, MO
6095,250,229,35,514,Solano County,6, CA
48487,184,96,35,315,Wilbarger County,48, TX
56037,226,166,35,427,Sweetwater County,56, WY
48211,198,33,35,266,Hemphill County,48, TX
6071,235,227,35,497,San Bernardino County,6, CA
42053,76,242,36,354,Forest County,42, PA
1125,167,131,36,334,Tuscaloosa County,1, AL
26021,118,209,36,363,Berrien County,26, MI
12027,227,63,36,326,DeSoto County,12, FL
45083,168,131,36,335,Spartanburg County,45, SC
12127,234,174,36,444,Volusia County,12, FL
48029,226,170,36,432,Bexar County,48, TX
25027,151,215,36,402,Worcester County,25, MA
48485,180,135,36,351,Wichita County,48, TX
1027,148,24,36,208,Clay County,1, AL
19013,16,110,36,162,Black Hawk County,19, IA
48479,192,207,36,435,Webb County,48, TX
47099,86,181,37,304,Lawrence County,47, TN
53053,243,231,37,511,Pierce County,53, WA
13233,148,101,37,286,Polk County,13, GA
24029,122,131,37,290,Kent County,24, MD
20035,69,126,37,232,Cowley County,20, KS
20009,86,40,37,163,Barton County,20, KS
48219,159,186,37,382,Hockley County,48, TX
26153,77,233,37,347,Schoolcraft County,26, MI
19187,13,63,37,113,Webster County,19, IA
48401,214,162,37,413,Rusk County,48, TX
12063,211,73,37,321,Jackson County,12, FL
17187,14,110,37,161,Warren County,17, IL
47035,169,177,38,384,Cumberland County,47, TN
29209,220,234,38,492,Stone County,29, MO
48309,179,110,38,327,McLennan County,48, TX
47169,118,106,38,262,Trousdale County,47, TN
25001,206,239,38,483,Barnstable County,25, MA
13069,107,91,38,236,Coffee County,13, GA
48495,200,225,38,463,Winkler County,48, TX
37191,64,126,38,228,Wayne County,37, NC
22059,135,43,38,216,La Salle Parish,22, LA
47185,92,153,38,283,White County,47, TN
48433,171,54,38,263,Stonewall County,48, TX
47167,112,144,38,294,Tipton County,47, TN
48041,171,67,39,277,Brazos County,48, TX
45035,75,91,39,205,Dorchester County,45, SC
20055,114,14,39,167,Finney County,20, KS
51700,198,212,39,449,Newport News city,51, VA
29097,35,87,39,161,Jasper County,29, MO
48439,189,162,39,390,Tarrant County,48, TX
1019,174,40,39,253,Cherokee County,1, AL
29051,187,33,39,259,Cole County,29, MO
5041,78,149,39,266,Desha County,5, AR
51670,153,243,39,435,Hopewell city,51, VA
18089,74,240,39,353,Lake County,18, IN
45075,152,220,39,411,Orangeburg County,45, SC
8055,247,227,40,514,Huerfano County,8, CO
1109,84,50,40,174,Pike County,1, AL
29167,100,43,40,183,Polk County,29, MO
13221,73,46,40,159,Oglethorpe County,13, GA
48507,166,253,40,459,Zavala County,48, TX
1045,107,50,40,197,Dale County,1, AL
48111,149,6,40,195,Dallam County,48, TX
6045,255,218,40,513,Mendocino County,6, CA
29217,56,33,40,129,Vernon County,29, MO
6035,251,153,40,444,Lassen County,6, CA
4013,244,166,40,450,Maricopa County,4, AZ
27053,39,131,40,210,Hennepin County,27, MN
42003,165,220,41,426,Allegheny County,42, PA
20051,34,14,41,89,Ellis County,20, KS
13299,126,83,41,250,Ware County,13, GA
48075,189,18,41,248,Childress County,48, TX
35023,234,91,41,366,Hidalgo County,35, NM
13015,194,110,41,345,Bartow County,13, GA
17069,141,223,41,405,Hardin County,17, IL
12019,217,73,41,331,Clay County,12, FL
18039,22,170,41,233,Elkhart County,18, IN
47179,175,120,41,336,Washington County,47, TN
48027,197,149,41,387,Bell County,48, TX
29039,196,37,41,274,Cedar County,29, MO
45019,205,116,42,363,Charleston County,45, SC
13039,214,43,42,299,Camden County,13, GA
47059,145,201,42,388,Greene County,47, TN
1069,91,73,42,206,Houston County,1, AL
35009,186,78,42,306,Curry County,35, NM
6013,254,218,42,514,Contra Costa County,6, CA
37195,70,218,42,330,Wilson County,37, NC
48481,81,140,42,263,Wharton County,48, TX
6043,254,245,42,541,Mariposa County,6, CA
39113,37,209,42,288,Montgomery County,39, OH
37147,51,140,42,233,Pitt County,37, NC
4012,240,153,42,435,La Paz County,4, AZ
42089,186,248,43,477,Monroe County,42, PA
51630,82,158,43,283,Fredericksburg city,51, VA
17127,53,237,43,333,Massac County,17, IL
54045,79,250,43,372,Logan County,54, WV
1101,119,181,43,343,Montgomery County,1, AL
30047,238,110,43,391,Lake County,30, MT
29169,169,83,43,295,Pulaski County,29, MO
26081,35,174,43,252,Kent County,26, MI
47153,109,181,43,333,Sequatchie County,47, TN
47147,45,106,43,194,Robertson County,47, TN
29083,108,96,43,247,Henry County,29, MO
13059,95,120,43,258,Clarke County,13, GA
29069,40,162,44,246,Dunklin County,29, MO
12111,245,181,44,470,St. Lucie County,12, FL
48463,240,120,44,404,Uvalde County,48, TX
51620,83,207,44,334,Franklin city,51, VA
9009,225,190,44,459,New Haven County,9, CT
48311,211,6,44,261,McMullen County,48, TX
48471,191,158,44,393,Walker County,48, TX
13005,107,50,44,201,Bacon County,13, GA
48423,177,140,44,361,Smith County,48, TX
28149,127,212,44,383,Warren County,28, MS
37129,197,162,44,403,New Hanover County,37, NC
20079,52,67,44,163,Harvey County,20, KS
48141,242,201,45,488,El Paso County,48, TX
5051,209,190,45,444,Garland County,5, AR
35051,252,223,45,520,Sierra County,35, NM
6115,245,242,45,532,Yuba County,6, CA
1067,141,46,45,232,Henry County,1, AL
13181,193,73,45,311,Lincoln County,13, GA
5019,193,96,45,334,Clark County,5, AR
13071,153,37,45,235,Colquitt County,13, GA
30085,28,101,45,174,Roosevelt County,30, MT
6087,254,229,45,528,Santa Cruz County,6, CA
22013,135,177,45,357,Bienville Parish,22, LA
17115,21,236,45,302,Macon County,17, IL
18079,27,174,46,247,Jennings County,18, IN
13051,211,174,46,431,Chatham County,13, GA
29203,122,162,46,330,Shannon County,29, MO
1071,197,67,46,310,Jackson County,1, AL
40015,186,96,46,328,Caddo County,40, OK
19003,80,20,46,146,Adams County,19, IA
13179,205,110,46,361,Liberty County,13, GA
28107,132,234,46,412,Panola County,28, MS
47003,104,186,46,336,Bedford County,47, TN
22113,163,166,46,375,Vermilion Parish,22, LA
29021,107,50,46,203,Buchanan County,29, MO
22109,167,177,46,390,Terrebonne Parish,22, LA
20057,88,13,47,148,Ford County,20, KS
48005,215,174,47,436,Angelina County,48, TX
45015,177,83,47,307,Berkeley County,45, SC
13155,150,78,47,275,Irwin County,13, GA
36063,105,241,47,393,Niagara County,36, NY
1049,56,37,47,140,DeKalb County,1, AL
13257,169,120,47,336,Stephens County,13, GA
22063,141,120,47,308,Livingston Parish,22, LA
48349,170,110,47,327,Navarro County,48, TX
47055,61,205,47,313,Giles County,47, TN
8041,246,162,47,455,El Paso County,8, CO
39017,54,158,47,259,Butler County,39, OH
48241,220,246,48,514,Jasper County,48, TX
45077,230,67,48,345,Pickens County,45, SC
47177,62,218,48,328,Warren County,47, TN
13105,115,144,48,307,Elbert County,13, GA
39153,30,197,48,275,Summit County,39, OH
6083,255,190,48,493,Santa Barbara County,6, CA
13273,123,170,48,341,Terrell County,13, GA
6069,247,236,48,531,San Benito County,6, CA
21209,46,116,48,210,Scott County,21, KY
24017,170,135,48,353,Charles County,24, MD
45005,120,227,48,395,Allendale County,45, SC
48185,178,190,48,416,Grimes County,48, TX
26077,40,158,49,247,Kalamazoo County,26, MI
13079,187,54,49,290,Crawford County,13, GA
32031,252,181,49,482,Washoe County,32, NV
22007,122,237,49,408,Assumption Parish,22, LA
36067,35,205,49,289,Onondaga County,36, NY
17161,47,227,49,323,Rock Island County,17, IL
37071,162,190,49,401,Gaston County,37, NC
48001,191,83,49,323,Anderson County,48, TX
25009,204,234,49,487,Essex County,25, MA
13003,151,22,49,222,Atkinson County,13, GA
48213,227,120,49,396,Henderson County,48, TX
54109,66,242,49,357,Wyoming County,54, WV
13147,172,73,50,295,Hart County,13, GA
47013,214,174,50,438,Campbell County,47, TN
1133,184,43,50,277,Winston County,1, AL
20045,158,106,50,314,Douglas County,20, KS
17125,47,190,50,287,Mason County,17, IL
48263,164,22,50,236,Kent County,48, TX
28133,61,246,50,357,Sunflower County,28, MS
27021,31,223,50,304,Cass County,27, MN
37047,112,197,50,359,Columbus County,37, NC
21067,31,87,50,168,Fayette County,21, KY
13253,183,54,50,287,Seminole County,13, GA
6073,254,223,50,527,San Diego County,6, CA
38105,43,231,51,325,Williams County,38, ND
48049,158,126,51,335,Brown County,48, TX
40071,140,135,51,326,Kay County,40, OK
48441,217,78,51,346,Taylor County,48, TX
30065,196,106,51,353,Musselshell County,30, MT
53063,201,215,51,467,Spokane County,53, WA
54055,54,227,51,332,Mercer County,54, WV
47143,201,234,51,486,Rhea County,47, TN
19127,6,153,51,210,Marshall County,19, IA
51550,166,106,51,323,Chesapeake city,51, VA
47129,105,126,51,282,Morgan County,47, TN
25023,191,229,52,472,Plymouth County,25, MA
29019,135,29,52,216,Boone County,29, MO
31109,25,29,52,106,Lancaster County,31, NE
24001,197,181,52,430,Allegany County,24, MD
48055,168,116,52,336,Caldwell County,48, TX
5095,74,135,52,261,Monroe County,5, AR
20151,63,16,52,131,Pratt County,20, KS
39099,52,239,52,343,Mahoning County,39, OH
48415,204,197,52,453,Scurry County,48, TX
30035,243,234,52,529,Glacier County,30, MT
12029,223,78,52,353,Dixie County,12, FL
29149,92,135,52,279,Oregon County,29, MO
29179,203,87,53,343,Reynolds County,29, MO
5067,48,153,53,254,Jackson County,5, AR
13217,205,153,53,411,Newton County,13, GA
48277,158,126,53,337,Lamar County,48, TX
29031,185,63,53,301,Cape Girardeau County,29, MO
6097,253,186,53,492,Sonoma County,6, CA
5043,70,144,53,267,Drew County,5, AR
37017,117,158,53,328,Bladen County,37, NC
12131,219,96,53,368,Walton County,12, FL
24047,157,246,53,456,Worcester County,24, MD
5111,35,78,53,166,Poinsett County,5, AR
41041,250,245,53,548,Lincoln County,41, OR
53077,205,233,54,492,Yakima County,53, WA
19183,12,27,54,93,Washington County,19, IA
20005,92,144,54,290,Atchison County,20, KS
48395,173,120,54,347,Robertson County,48, TX
13247,145,174,54,373,Rockdale County,13, GA
4017,214,237,54,505,Navajo County,4, AZ
13111,228,43,54,325,Fannin County,13, GA
51089,119,174,54,347,Henry County,51, VA
17055,72,242,54,368,Franklin County,17, IL
8047,252,247,54,553,Gilpin County,8, CO
13115,157,116,54,327,Floyd County,13, GA
36055,93,209,54,356,Monroe County,36, NY
6005,253,221,55,529,Amador County,6, CA
5103,86,101,55,242,Ouachita County,5, AR
5009,216,67,55,338,Boone County,5, AR
48361,163,242,55,460,Orange County,48, TX
35049,230,201,55,486,Santa Fe County,35, NM
37139,163,162,55,380,Pasquotank County,37, NC
1021,160,54,55,269,Chilton County,1, AL
12121,176,83,55,314,Suwannee County,12, FL
12057,241,153,55,449,Hillsborough County,12, FL
47131,95,149,55,299,Obion County,47, TN
22099,115,194,55,364,St. Martin Parish,22, LA
48153,183,110,55,348,Floyd County,48, TX
17199,190,212,56,458,Williamson County,17, IL
2110,0,131,56,187,Juneau City and Borough,2, AK
37013,138,116,56,310,Beaufort County,37, NC
29025,20,73,56,149,Caldwell County,29, MO
24011,53,78,56,187,Caroline County,24, MD
48293,192,153,56,401,Limestone County,48, TX
32007,217,87,56,360,Elko County,32, NV
48335,224,186,56,466,Mitchell County,48, TX
40141,162,116,56,334,Tillman County,40, OK
37077,83,96,56,235,Granville County,37, NC
45063,188,33,56,277,Lexington County,45, SC
44007,187,239,56,482,Providence County,44, RI
48203,168,186,57,411,Harrison County,48, TX
12105,239,220,57,516,Polk County,12, FL
47043,89,96,57,242,Dickson County,47, TN
48437,162,63,57,282,Swisher County,48, TX
35017,251,220,57,528,Grant County,35, NM
5037,82,106,57,245,Cross County,5, AR
4027,240,254,57,551,Yuma County,4, AZ
51520,122,177,57,356,Bristol city,51, VA
6055,253,212,57,522,Napa County,6, CA
37169,138,120,57,315,Stokes County,37, NC
48453,232,116,57,405,Travis County,48, TX
47009,197,120,57,374,Blount County,47, TN
29049,60,96,58,214,Clinton County,29, MO
34039,145,236,58,439,Union County,34, NJ
51680,112,158,58,328,Lynchburg city,51, VA
47041,196,221,58,475,DeKalb County,47, TN
35057,239,229,58,526,Torrance County,35, NM
48409,216,240,58,514,San Patricio County,48, TX
29186,218,50,58,326,Ste. Genevieve County,29, MO
47001,202,135,58,395,Anderson County,47, TN
46065,141,13,58,212,Hughes County,46, SD
28075,200,170,58,428,Lauderdale County,28, MS
48195,140,14,58,212,Hansford County,48, TX
45065,180,135,58,373,McCormick County,45, SC
1031,97,33,59,189,Coffee County,1, AL
12047,170,174,59,403,Hamilton County,12, FL
18141,26,205,59,290,St. Joseph County,18, IN
13275,154,110,59,323,Thomas County,13, GA
28143,111,253,59,423,Tunica County,28, MS
17165,110,233,59,402,Saline County,17, IL
51181,180,87,59,326,Surry County,51, VA
47183,55,91,59,205,Weakley County,47, TN
13175,137,135,59,331,Laurens County,13, GA
47021,122,83,59,264,Cheatham County,47, TN
20169,79,78,59,216,Saline County,20, KS
17153,63,249,59,371,Pulaski County,17, IL
37187,156,197,60,413,Washington County,37, NC
12071,247,162,60,469,Lee County,12, FL
13235,154,37,60,251,Pulaski County,13, GA
40027,190,83,60,333,Cleveland County,40, OK
22127,134,153,60,347,Winn Parish,22, LA
47117,86,221,60,367,Marshall County,47, TN
53033,242,170,60,472,King County,53, WA
40051,121,106,60,287,Grady County,40, OK
35028,230,18,60,308,Los Alamos County,35, NM
21073,115,131,60,306,Franklin County,21, KY
8001,224,190,60,474,Adams County,8, CO
48021,186,101,60,347,Bastrop County,48, TX
13173,186,63,61,310,Lanier County,13, GA
1131,208,253,61,522,Wilcox County,1, AL
28137,96,177,61,334,Tate County,28, MS
4005,244,233,61,538,Coconino County,4, AZ
20099,77,83,61,221,Labette County,20, KS
47101,90,170,61,321,Lewis County,47, TN
6101,211,245,61,517,Sutter County,6, CA
20175,123,33,61,217,Seward County,20, KS
47155,211,231,61,503,Sevier County,47, TN
25003,180,221,61,462,Berkshire County,25, MA
28025,114,248,61,423,Clay County,28, MS
8121,170,9,61,240,Washington County,8, CO
19079,5,33,62,100,Hamilton County,19, IA
13153,134,63,62,259,Houston County,13, GA
42011,94,229,62,385,Berks County,42, PA
20167,144,29,62,235,Russell County,20, KS
19117,24,16,62,102,Lucas County,19, IA
54011,143,190,62,395,Cabell County,54, WV
12117,231,158,62,451,Seminole County,12, FL
45003,134,54,62,250,Aiken County,45, SC
20037,80,78,62,220,Crawford County,20, KS
55003,99,207,62,368,Ashland County,55, WI
19007,106,67,62,235,Appanoose County,19, IA
51683,83,126,62,271,Manassas city,51, VA
36001,155,158,63,376,Albany County,36, NY
48321,207,242,63,512,Matagorda County,48, TX
42063,161,221,63,445,Indiana County,42, PA
17135,38,212,63,313,Montgomery County,17, IL
46099,25,37,63,125,Minnehaha County,46, SD
22119,177,186,63,426,Webster Parish,22, LA
5089,227,120,63,410,Marion County,5, AR
13171,102,116,63,281,Lamar County,13, GA
13129,105,78,63,246,Gordon County,13, GA
16013,229,181,63,473,Blaine County,16, ID
6079,253,177,63,493,San Luis Obispo County,6, CA
48347,218,131,63,412,Nacogdoches County,48, TX
1121,201,149,64,414,Talladega County,1, AL
37061,60,83,64,207,Duplin County,37, NC
54101,33,227,64,324,Webster County,54, WV
37197,148,153,64,365,Yadkin County,37, NC
1129,107,190,64,361,Washington County,1, AL
22121,136,158,64,358,West Baton Rouge Parish,22, LA
22061,81,116,64,261,Lincoln Parish,22, LA
47173,201,144,64,409,Union County,47, TN
19171,11,58,64,133,Tama County,19, IA
12017,234,205,64,503,Citrus County,12, FL
12069,234,218,64,516,Lake County,12, FL
54107,125,215,64,404,Wood County,54, WV
47095,114,215,65,394,Lake County,47, TN
47189,89,116,65,270,Wilson County,47, TN
16085,242,186,65,493,Valley County,16, ID
5031,36,67,65,168,Craighead County,5, AR
13229,99,37,65,201,Pierce County,13, GA
30095,226,58,65,349,Stillwater County,30, MT
49035,240,58,65,363,Salt Lake County,49, UT
22085,209,78,65,352,Sabine Parish,22, LA
29091,156,135,65,356,Howell County,29, MO
48419,224,140,65,429,Shelby County,48, TX
20109,63,3,65,131,Logan County,20, KS
54079,109,166,65,340,Putnam County,54, WV
54047,47,251,66,364,McDowell County,54, WV
29181,166,186,66,418,Ripley County,29, MO
13091,131,101,66,298,Dodge County,13, GA
37173,229,207,66,502,Swain County,37, NC
17113,8,140,66,214,McLean County,17, IL
51820,128,126,66,320,Waynesboro city,51, VA
4025,247,170,66,483,Yavapai County,4, AZ
48405,216,231,66,513,San Augustine County,48, TX
42007,174,240,66,480,Beaver County,42, PA
12101,234,158,66,458,Pasco County,12, FL
39089,104,126,66,296,Licking County,39, OH
13185,153,101,66,320,Lowndes County,13, GA
48287,184,50,67,301,Lee County,48, TX
51800,146,126,67,339,Suffolk city,51, VA
20043,41,37,67,145,Doniphan County,20, KS
17053,3,120,67,190,Ford County,17, IL
1061,106,27,67,200,Geneva County,1, AL
17045,7,131,67,205,Edgar County,17, IL
25011,137,166,67,370,Franklin County,25, MA
8077,221,170,67,458,Mesa County,8, CO
41029,242,181,67,490,Jackson County,41, OR
12115,243,140,67,450,Sarasota County,12, FL
48215,165,248,67,480,Hidalgo County,48, TX
13177,149,40,67,256,Lee County,13, GA
5033,204,73,68,345,Crawford County,5, AR
26075,28,220,68,316,Jackson County,26, MI
5047,217,83,68,368,Franklin County,5, AR
13285,185,162,68,415,Troup County,13, GA
20145,41,20,68,129,Pawnee County,20, KS
46091,54,46,68,168,Marshall County,46, SD
51590,118,233,68,419,Danville city,51, VA
29041,140,24,68,232,Chariton County,29, MO
5045,131,73,68,272,Faulkner County,5, AR
5081,132,120,68,320,Little River County,5, AR
29153,208,158,68,434,Ozark County,29, MO
40057,108,14,68,190,Harmon County,40, OK
45021,117,194,69,380,Cherokee County,45, SC
37159,130,186,69,385,Rowan County,37, NC
19153,39,101,69,209,Polk County,19, IA
6051,254,249,69,572,Mono County,6, CA
37041,168,106,69,343,Chowan County,37, NC
5085,91,78,69,238,Lonoke County,5, AR
35037,209,166,69,444,Quay County,35, NM
26149,30,221,69,320,St. Joseph County,26, MI
37035,200,190,69,459,Catawba County,37, NC
40001,188,91,69,348,Adair County,40, OK
5053,50,63,69,182,Grant County,5, AR
47079,140,170,69,379,Henry County,47, TN
53023,221,205,70,496,Garfield County,53, WA
47115,181,174,70,425,Marion County,47, TN
37049,147,131,70,348,Craven County,37, NC
8051,244,131,70,445,Gunnison County,8, CO
18163,27,158,70,255,Vanderburgh County,18, IN
5061,188,54,70,312,Howard County,5, AR
54031,181,158,70,409,Hardy County,54, WV
17091,12,215,70,297,Kankakee County,17, IL
12061,243,166,70,479,Indian River County,12, FL
24039,134,201,70,405,Somerset County,24, MD
29013,54,67,70,191,Bates County,29, MO
6007,246,223,70,539,Butte County,6, CA
27087,15,252,71,338,Mahnomen County,27, MN
40137,193,177,71,441,Stephens County,40, OK
17191,24,201,71,296,Wayne County,17, IL
47161,187,131,71,389,Stewart County,47, TN
13163,108,135,71,314,Jefferson County,13, GA
20093,114,4,71,189,Kearny County,20, KS
48365,201,205,71,477,Panola County,48, TX
48371,241,194,71,506,Pecos County,48, TX
9003,190,194,71,455,Hartford County,9, CT
19193,60,67,71,198,Woodbury County,19, IA
53015,242,225,71,538,Cowlitz County,53, WA
12067,182,29,71,282,Lafayette County,12, FL
6065,252,236,72,560,Riverside County,6, CA
31161,216,2,72,290,Sheridan County,31, NE
42033,180,223,72,475,Clearfield County,42, PA
47087,183,190,72,445,Jackson County,47, TN
28151,79,245,72,396,Washington County,28, MS
17001,40,116,72,228,Adams County,17, IL
49021,223,37,72,332,Iron County,49, UT
39151,27,194,72,293,Stark County,39, OH
29189,174,116,72,362,St. Louis County,29, MO
48067,173,186,72,431,Cass County,48, TX
36007,88,212,72,372,Broome County,36, NY
47089,203,170,72,445,Jefferson County,47, TN
37091,69,149,73,291,Hertford County,37, NC
48457,194,236,73,503,Tyler County,48, TX
18157,21,116,73,210,Tippecanoe County,18, IN
26017,59,223,73,355,Bay County,26, MI
15007,0,254,73,327,Kauai County,15, HI
22083,51,174,73,298,Richland Parish,22, LA
17095,29,209,73,311,Knox County,17, IL
48237,158,149,73,380,Jack County,48, TX
13045,129,120,73,322,Carroll County,13, GA
48329,203,194,73,470,Midland County,48, TX
13133,222,96,73,391,Greene County,13, GA
49007,231,63,73,367,Carbon County,49, UT
13297,83,73,74,230,Walton County,13, GA
47139,210,144,74,428,Polk County,47, TN
5087,109,22,74,205,Madison County,5, AR
42113,137,207,74,418,Sullivan County,42, PA
13011,71,31,74,176,Banks County,13, GA
48323,168,254,74,496,Maverick County,48, TX
39023,42,194,74,310,Clark County,39, OH
8005,222,186,74,482,Arapahoe County,8, CO
20171,60,3,74,137,Scott County,20, KS
20123,156,4,74,234,Mitchell County,20, KS
28059,182,229,74,485,Jackson County,28, MS
32019,249,207,74,530,Lyon County,32, NV
19021,29,18,75,122,Buena Vista County,19, IA
12129,215,37,75,327,Wakulla County,12, FL
48357,161,91,75,327,Ochiltree County,48, TX
18177,26,140,75,241,Wayne County,18, IN
38017,1,33,75,109,Cass County,38, ND
54057,176,174,75,425,Mineral County,54, WV
19015,11,27,75,113,Boone County,19, IA
16055,235,144,75,454,Kootenai County,16, ID
12053,237,194,75,506,Hernando County,12, FL
17121,38,225,75,338,Marion County,17, IL
47111,40,126,75,241,Macon County,47, TN
47165,152,126,75,353,Sumner County,47, TN
1079,169,50,76,295,Lawrence County,1, AL
47133,148,116,76,340,Overton County,47, TN
26161,38,120,76,234,Washtenaw County,26, MI
27095,51,205,76,332,Mille Lacs County,27, MN
41037,240,83,76,399,Lake County,41, OR
48089,211,83,76,370,Colorado County,48, TX
53025,172,215,76,463,Grant County,53, WA
37031,196,110,76,382,Carteret County,37, NC
13093,128,177,76,381,Dooly County,13, GA
28123,73,91,76,240,Scott County,28, MS
37171,196,144,76,416,Surry County,37, NC
46035,12,29,76,117,Davison County,46, SD
30049,232,54,77,363,Lewis and Clark County,30, MT
47135,163,229,77,469,Perry County,47, TN
12043,246,83,77,406,Glades County,12, FL
17079,36,101,77,214,Jasper County,17, IL
9001,220,186,77,483,Fairfield County,9, CT
28021,114,253,77,444,Claiborne County,28, MS
30063,211,116,77,404,Missoula County,30, MT
22111,149,153,77,379,Union Parish,22, LA
13205,108,126,77,311,Mitchell County,13, GA
26099,70,249,77,396,Macomb County,26, MI
48445,192,162,77,431,Terry County,48, TX
30009,240,101,77,418,Carbon County,30, MT
48063,177,166,78,421,Camp County,48, TX
5105,184,78,78,340,Perry County,5, AR
26085,53,244,78,375,Lake County,26, MI
30023,206,58,78,342,Deer Lodge County,30, MT
40039,165,73,78,316,Custer County,40, OK
47051,210,186,78,474,Franklin County,47, TN
20067,82,27,78,187,Grant County,20, KS
6023,255,205,78,538,Humboldt County,6, CA
45053,171,58,78,307,Jasper County,45, SC
5113,191,131,78,400,Polk County,5, AR
32011,215,14,78,307,Eureka County,32, NV
55019,2,37,78,117,Clark County,55, WI
36071,142,205,79,426,Orange County,36, NY
37097,200,162,79,441,Iredell County,37, NC
16053,173,24,79,276,Jerome County,16, ID
19129,80,22,79,181,Mills County,19, IA
28063,95,255,79,429,Jefferson County,28, MS
48459,154,177,79,410,Upshur County,48, TX
30111,191,73,79,343,Yellowstone County,30, MT
30005,147,46,79,272,Blaine County,30, MT
26039,31,241,79,351,Crawford County,26, MI
13201,74,24,79,177,Miller County,13, GA
8063,136,6,79,221,Kit Carson County,8, CO
17061,36,126,79,241,Greene County,17, IL
18003,17,177,80,274,Allen County,18, IN
30083,122,120,80,322,Richland County,30, MT
29219,145,91,80,316,Warren County,29, MO
47067,160,205,80,445,Hancock County,47, TN
1051,218,50,80,348,Elmore County,1, AL
26033,64,218,80,362,Chippewa County,26, MI
48129,183,33,80,296,Donley County,48, TX
17189,37,67,80,184,Washington County,17, IL
51690,119,245,80,444,Martinsville city,51, VA
37131,98,162,80,340,Northampton County,37, NC
48279,200,63,80,343,Lamb County,48, TX
20007,68,13,80,161,Barber County,20, KS
12075,224,101,81,406,Levy County,12, FL
13279,151,131,81,363,Toombs County,13, GA
26159,100,201,81,382,Van Buren County,26, MI
32013,238,50,81,369,Humboldt County,32, NV
29159,42,140,81,263,Pettis County,29, MO
54059,74,253,81,408,Mingo County,54, WV
12109,230,67,81,378,St. Johns County,12, FL
42079,155,245,81,481,Luzerne County,42, PA
29009,215,126,81,422,Barry County,29, MO
30007,238,116,81,435,Broadwater County,30, MT
5055,43,101,81,225,Greene County,5, AR
12133,215,91,81,387,Washington County,12, FL
1093,117,58,82,257,Marion County,1, AL
28163,85,233,82,400,Yazoo County,28, MS
18143,45,205,82,332,Scott County,18, IN
13159,205,50,82,337,Jasper County,13, GA
24025,139,91,82,312,Harford County,24, MD
6021,241,218,82,541,Glenn County,6, CA
36083,107,149,82,338,Rensselaer County,36, NY
19181,38,40,82,160,Warren County,19, IA
41013,246,215,82,543,Crook County,41, OR
6025,251,255,82,588,Imperial County,6, CA
31079,48,91,82,221,Hall County,31, NE
13035,213,110,82,405,Butts County,13, GA
55009,66,101,83,250,Brown County,55, WI
49019,218,229,83,530,Grand County,49, UT
47083,170,197,83,450,Houston County,47, TN
35003,251,158,83,492,Catron County,35, NM
40097,148,54,83,285,Mayes County,40, OK
54075,110,225,83,418,Pocahontas County,54, WV
26095,71,209,83,363,Luce County,26, MI
16009,231,170,83,484,Benewah County,16, ID
26105,171,223,83,477,Mason County,26, MI
12049,220,126,83,429,Hardee County,12, FL
40065,133,27,83,243,Jackson County,40, OK
2050,0,248,83,331,Bethel Census Area,2, AK
38015,43,33,84,160,Burleigh County,38, ND
20059,44,73,84,201,Franklin County,20, KS
13097,108,166,84,358,Douglas County,13, GA
5011,77,91,84,252,Bradley County,5, AR
40147,187,96,84,367,Washington County,40, OK
42093,143,106,84,333,Montour County,42, PA
8123,210,149,84,443,Weld County,8, CO
37157,143,205,84,432,Rockingham County,37, NC
5149,209,58,84,351,Yell County,5, AR
48451,226,116,84,426,Tom Green County,48, TX
17029,17,166,84,267,Coles County,17, IL
13199,101,209,84,394,Meriwether County,13, GA
20039,89,18,85,192,Decatur County,20, KS
40047,69,78,85,232,Garfield County,40, OK
16083,187,67,85,339,Twin Falls County,16, ID
40023,154,174,85,413,Choctaw County,40, OK
41033,240,186,85,511,Josephine County,41, OR
37145,201,166,85,452,Person County,37, NC
53009,251,239,85,575,Clallam County,53, WA
41045,210,63,85,358,Malheur County,41, OR
56015,216,31,85,332,Goshen County,56, WY
6113,246,170,85,501,Yolo County,6, CA
13269,100,135,85,320,Taylor County,13, GA
20021,81,63,85,229,Cherokee County,20, KS
42123,95,194,86,375,Warren County,42, PA
12055,239,177,86,502,Highlands County,12, FL
13271,114,236,86,436,Telfair County,13, GA
54061,132,116,86,334,Monongalia County,54, WV
48217,181,116,86,383,Hill County,48, TX
54019,128,237,86,451,Fayette County,54, WV
30029,228,181,86,495,Flathead County,30, MT
40095,225,120,86,431,Marshall County,40, OK
53035,226,177,86,489,Kitsap County,53, WA
29187,210,149,86,445,St. Francois County,29, MO
54077,88,162,86,336,Preston County,54, WV
40153,98,135,86,319,Woodward County,40, OK
38053,133,174,87,394,McKenzie County,38, ND
1111,177,43,87,307,Randolph County,1, AL
48091,232,110,87,429,Comal County,48, TX
5029,110,101,87,298,Conway County,5, AR
35035,239,201,87,527,Otero County,35, NM
17193,49,174,87,310,White County,17, IL
48167,214,212,87,513,Galveston County,48, TX
53045,247,234,87,568,Mason County,53, WA
37033,164,181,87,432,Caswell County,37, NC
5007,223,37,87,347,Benton County,5, AR
51057,166,149,87,402,Essex County,51, VA
18067,7,245,87,339,Howard County,18, IN
34033,124,229,88,441,Salem County,34, NJ
40113,194,120,88,402,Osage County,40, OK
40115,139,87,88,314,Ottawa County,40, OK
34009,141,253,88,482,Cape May County,34, NJ
8019,252,207,88,547,Clear Creek County,8, CO
28093,80,174,88,342,Marshall County,28, MS
29161,126,46,88,260,Phelps County,29, MO
37055,209,234,88,531,Dare County,37, NC
54099,125,205,88,418,Wayne County,54, WV
6085,250,149,88,487,Santa Clara County,6, CA
18173,49,73,88,210,Warrick County,18, IN
26115,63,218,88,369,Monroe County,26, MI
29229,183,149,89,421,Wright County,29, MO
13067,126,96,89,311,Cobb County,13, GA
13313,114,162,89,365,Whitfield County,13, GA
42025,175,234,89,498,Carbon County,42, PA
37087,220,170,89,479,Haywood County,37, NC
29185,192,106,89,387,St. Clair County,29, MO
48071,208,229,89,526,Chambers County,48, TX
13321,140,73,89,302,Worth County,13, GA
1077,184,78,89,351,Lauderdale County,1, AL
26041,45,212,89,346,Delta County,26, MI
20107,59,149,89,297,Linn County,20, KS
12085,248,106,89,443,Martin County,12, FL
37185,121,234,90,445,Warren County,37, NC
54001,149,201,90,440,Barbour County,54, WV
48205,168,1,90,259,Hartley County,48, TX
18035,24,162,90,276,Delaware County,18, IN
40135,225,140,90,455,Sequoyah County,40, OK
13187,198,46,90,334,Lumpkin County,13, GA
29027,132,37,90,259,Callaway County,29, MO
48427,216,255,90,561,Starr County,48, TX
46019,163,73,90,326,Butte County,46, SD
18095,9,186,90,285,Madison County,18, IN
40079,200,149,90,439,Le Flore County,40, OK
54033,66,186,90,342,Harrison County,54, WV
19145,48,54,91,193,Page County,19, IA
46007,167,54,91,312,Bennett County,46, SD
35043,236,209,91,536,Sandoval County,35, NM
26165,92,239,91,422,Wexford County,26, MI
16079,236,221,91,548,Shoshone County,16, ID
47181,95,153,91,339,Wayne County,47, TN
40049,160,110,91,361,Garvin County,40, OK
27119,5,83,91,179,Polk County,27, MN
42077,111,231,91,433,Lehigh County,42, PA
18105,154,78,91,323,Monroe County,18, IN
20017,86,78,91,255,Chase County,20, KS
26147,69,249,91,409,St. Clair County,26, MI
31031,94,2,92,188,Cherry County,31, NE
21047,99,181,92,372,Christian County,21, KY
48061,224,239,92,555,Cameron County,48, TX
17037,7,197,92,296,DeKalb County,17, IL
24043,182,135,92,409,Washington County,24, MD
1039,126,50,92,268,Covington County,1, AL
18023,1,83,92,176,Clinton County,18, IN
30093,219,131,92,442,Silver Bow County,30, MT
36065,54,194,92,340,Oneida County,36, NY
12125,208,43,92,343,Union County,12, FL
29121,104,46,92,242,Macon County,29, MO
12035,227,174,92,493,Flagler County,12, FL
17107,5,135,93,233,Logan County,17, IL
47159,183,101,93,377,Smith County,47, TN
24021,143,96,93,332,Frederick County,24, MD
15009,0,255,93,348,Maui County,15, HI
13043,161,33,93,287,Candler County,13, GA
26079,75,246,93,414,Kalkaska County,26, MI
42109,99,174,93,366,Snyder County,42, PA
1103,191,37,93,321,Morgan County,1, AL
37085,105,170,93,368,Harnett County,37, NC
20191,73,194,93,360,Sumner County,20, KS
5115,221,96,93,410,Pope County,5, AR
48181,179,96,93,368,Grayson County,48, TX
42013,87,212,94,393,Blair County,42, PA
8043,243,177,94,514,Fremont County,8, CO
5141,223,153,94,470,Van Buren County,5, AR
53021,112,220,94,426,Franklin County,53, WA
35027,240,215,94,549,Lincoln County,35, NM
28087,132,201,94,427,Lowndes County,28, MS
48251,144,126,94,364,Johnson County,48, TX
29145,114,91,94,299,Newton County,29, MO
49047,235,223,94,552,Uintah County,49, UT
28037,68,201,94,363,Franklin County,28, MS
30027,226,40,94,360,Fergus County,30, MT
36119,180,205,94,479,Westchester County,36, NY
47005,193,197,95,485,Benton County,47, TN
51650,198,207,95,500,Hampton city,51, VA
1001,179,50,95,324,Autauga County,1, AL
54049,105,212,95,412,Marion County,54, WV
47049,133,126,95,354,Fentress County,47, TN
46027,47,37,95,179,Clay County,46, SD
13149,149,126,95,370,Heard County,13, GA
36015,74,215,95,384,Chemung County,36, NY
42009,97,221,95,413,Bedford County,42, PA
37069,63,140,95,298,Franklin County,37, NC
27065,16,190,95,301,Kanabec County,27, MN
26123,68,212,95,375,Newaygo County,26, MI
5125,166,58,96,320,Saline County,5, AR
47151,154,209,96,459,Scott County,47, TN
26129,46,245,96,387,Ogemaw County,26, MI
42133,101,190,96,387,York County,42, PA
47145,196,131,96,423,Roane County,47, TN
30067,236,166,96,498,Park County,30, MT
20207,114,96,96,306,Woodson County,20, KS
47023,43,87,96,226,Chester County,47, TN
55101,106,162,96,364,Racine County,55, WI
5015,211,87,96,394,Carroll County,5, AR
37183,150,120,96,366,Wake County,37, NC
42049,102,234,96,432,Erie County,42, PA
20139,72,58,97,227,Osage County,20, KS
46029,51,50,97,198,Codington County,46, SD
56007,248,37,97,382,Carbon County,56, WY
48157,105,177,97,379,Fort Bend County,48, TX
6057,253,190,97,540,Nevada County,6, CA
29177,94,144,97,335,Ray County,29, MO
17131,28,190,97,315,Mercer County,17, IL
13303,123,120,97,340,Washington County,13, GA
1081,121,63,97,281,Lee County,1, AL
54051,115,236,97,448,Marshall County,54, WV
5137,207,153,97,457,Stone County,5, AR
56029,239,73,97,409,Park County,56, WY
48007,237,207,98,542,Aransas County,48, TX
28001,144,245,98,487,Adams County,28, MS
8011,224,33,98,355,Bent County,8, CO
17033,29,149,98,276,Crawford County,17, IL
40121,209,174,98,481,Pittsburg County,40, OK
13251,135,197,98,430,Screven County,13, GA
48407,219,194,98,511,San Jacinto County,48, TX
13167,136,50,98,284,Johnson County,13, GA
37043,230,166,98,494,Clay County,37, NC
29127,61,46,98,205,Marion County,29, MO
5023,219,174,98,491,Cleburne County,5, AR
40061,216,181,98,495,Haskell County,40, OK
4007,253,177,99,529,Gila County,4, AZ
40145,140,91,99,330,Wagoner County,40, OK
5003,74,225,99,398,Ashley County,5, AR
6017,251,201,99,551,El Dorado County,6, CA
26097,82,252,99,433,Mackinac County,26, MI
32510,253,197,99,549,Carson City,32, NV
12021,245,144,99,488,Collier County,12, FL
29125,148,46,99,293,Maries County,29, MO
48341,224,20,99,343,Moore County,48, TX
18071,102,158,99,359,Jackson County,18, IN
27137,97,158,99,354,St. Louis County,27, MN
20001,63,73,99,235,Allen County,20, KS
33011,141,149,100,390,Hillsborough County,33, NH
12059,184,78,100,362,Holmes County,12, FL
55037,24,190,100,314,Florence County,55, WI
25015,136,158,100,394,Hampshire County,25, MA
22041,66,194,100,360,Franklin Parish,22, LA
19103,23,46,100,169,Johnson County,19, IA
54003,104,110,100,314,Berkeley County,54, WV
46083,4,16,100,120,Lincoln County,46, SD
27013,27,73,100,200,Blue Earth County,27, MN
29115,69,106,100,275,Linn County,29, MO
28113,119,218,100,437,Pike County,28, MS
20149,130,31,100,261,Pottawatomie County,20, KS
40117,137,126,101,364,Pawnee County,40, OK
12015,246,162,101,509,Charlotte County,12, FL
8109,244,149,101,494,Saguache County,8, CO
20081,100,2,101,203,Haskell County,20, KS
17041,8,83,101,192,Douglas County,17, IL
47073,195,177,101,473,Hawkins County,47, TN
27007,18,116,101,235,Beltrami County,27, MN
26133,33,201,101,335,Osceola County,26, MI
16039,229,46,101,376,Elmore County,16, ID
32009,239,63,101,403,Esmeralda County,32, NV
22021,158,162,101,421,Caldwell Parish,22, LA
48363,205,149,101,455,Palo Pinto County,48, TX
20161,129,54,102,285,Riley County,20, KS
17047,18,197,102,317,Edwards County,17, IL
48161,161,201,102,464,Freestone County,48, TX
19119,1,3,102,106,Lyon County,19, IA
37045,179,181,102,462,Cleveland County,37, NC
47081,38,91,102,231,Hickman County,47, TN
55105,24,153,102,279,Rock County,55, WI
37021,219,201,102,522,Buncombe County,37, NC
49045,228,46,102,376,Tooele County,49, UT
47017,46,166,102,314,Carroll County,47, TN
46135,50,40,102,192,Yankton County,46, SD
46005,12,22,103,137,Beadle County,46, SD
18093,114,144,103,361,Lawrence County,18, IN
38103,35,33,103,171,Wells County,38, ND
1043,174,31,103,308,Cullman County,1, AL
56009,228,101,103,432,Converse County,56, WY
15003,0,239,103,342,Honolulu County,15, HI
6093,233,233,103,569,Siskiyou County,6, CA
36105,145,215,103,463,Sullivan County,36, NY
20133,79,120,103,302,Neosho County,20, KS
26101,184,244,103,531,Manistee County,26, MI
37099,226,174,103,503,Jackson County,37, NC
56021,230,58,103,391,Laramie County,56, WY
12003,174,50,104,328,Baker County,12, FL
37179,115,101,104,320,Union County,37, NC
30013,220,96,104,420,Cascade County,30, MT
17087,154,218,104,476,Johnson County,17, IL
40011,124,96,104,324,Blaine County,40, OK
41039,241,186,104,531,Lane County,41, OR
17179,25,194,104,323,Tazewell County,17, IL
2016,0,37,104,141,Aleutians West Census Area,2, AK
41047,235,144,104,483,Marion County,41, OR
41053,233,131,104,468,Polk County,41, OR
16005,211,50,104,365,Bannock County,16, ID
6081,254,144,104,502,San Mateo County,6, CA
20179,71,2,105,178,Sheridan County,20, KS
39155,40,241,105,386,Trumbull County,39, OH
27061,32,205,105,342,Itasca County,27, MN
37193,214,140,105,459,Wilkes County,37, NC
24041,143,101,105,349,Talbot County,24, MD
24037,169,46,105,320,St. Mary's County,24, MD
16075,212,67,105,384,Payette County,16, ID
13213,194,174,105,473,Murray County,13, GA
49025,229,73,105,407,Kane County,49, UT
53071,190,144,105,439,Walla Walla County,53, WA
47175,67,212,105,384,Van Buren County,47, TN
30037,140,43,105,288,Golden Valley County,30, MT
50025,139,116,106,361,Windham County,50, VT
20101,85,7,106,198,Lane County,20, KS
2180,0,242,106,348,Nome Census Area,2, AK
51570,88,153,106,347,Colonial Heights city,51, VA
19087,17,67,106,190,Henry County,19, IA
47105,193,120,106,419,Loudon County,47, TN
42069,146,231,106,483,Lackawanna County,42, PA
48253,207,149,106,462,Jones County,48, TX
18081,73,83,106,262,Johnson County,18, IN
27099,0,54,106,160,Mower County,27, MN
20065,68,40,106,214,Graham County,20, KS
41017,251,186,106,543,Deschutes County,41, OR
48097,173,153,107,433,Cooke County,48, TX
30053,222,237,107,566,Lincoln County,30, MT
42051,153,249,107,509,Fayette County,42, PA
17137,36,144,107,287,Morgan County,17, IL
24023,158,131,107,396,Garrett County,24, MD
53001,67,162,107,336,Adams County,53, WA
1057,112,54,107,273,Fayette County,1, AL
42083,75,236,107,418,McKean County,42, PA
13083,112,27,107,246,Dade County,13, GA
48133,151,135,107,393,Eastland County,48, TX
8083,241,153,107,501,Montezuma County,8, CO
36013,120,218,107,445,Chautauqua County,36, NY
18167,40,186,108,334,Vigo County,18, IN
20181,67,13,108,188,Sherman County,20, KS
40119,162,67,108,337,Payne County,40, OK
19179,64,101,108,273,Wapello County,19, IA
17023,33,186,108,327,Clark County,17, IL
20087,77,50,108,235,Jefferson County,20, KS
48257,173,126,108,407,Kaufman County,48, TX
26083,163,218,108,489,Keweenaw County,26, MI
20203,49,1,108,158,Wichita County,20, KS
1003,213,83,108,404,Baldwin County,1, AL
20015,170,126,108,404,Butler County,20, KS
26155,9,223,108,340,Shiawassee County,26, MI
17105,4,135,109,248,Livingston County,17, IL
36027,132,177,109,418,Dutchess County,36, NY
28067,112,153,109,374,Jones County,28, MS
41035,246,212,109,567,Klamath County,41, OR
38035,1,40,109,150,Grand Forks County,38, ND
6009,254,174,109,537,Calaveras County,6, CA
17119,53,177,109,339,Madison County,17, IL
20193,57,7,109,173,Thomas County,20, KS
42021,122,229,109,460,Cambria County,42, PA
8059,249,153,109,511,Jefferson County,8, CO
53003,196,63,109,368,Asotin County,53, WA
19157,10,50,109,169,Poweshiek County,19, IA
8069,249,116,110,475,Larimer County,8, CO
48473,198,181,110,489,Waller County,48, TX
42097,177,227,110,514,Northumberland County,42, PA
17017,45,135,110,290,Cass County,17, IL
47015,21,126,110,257,Cannon County,47, TN
54013,31,254,110,395,Calhoun County,54, WV
22015,152,120,110,382,Bossier Parish,22, LA
37141,168,131,110,409,Pender County,37, NC
21021,122,166,110,398,Boyle County,21, KY
42085,21,233,110,364,Mercer County,42, PA
13123,222,43,110,375,Gilmer County,13, GA
26051,37,233,110,380,Gladwin County,26, MI
51580,212,231,111,554,Covington city,51, VA
13315,119,87,111,317,Wilcox County,13, GA
54005,46,242,111,399,Boone County,54, WV
53005,208,197,111,516,Benton County,53, WA
20129,57,8,111,176,Morton County,20, KS
22115,148,153,111,412,Vernon Parish,22, LA
26151,70,233,111,414,Sanilac County,26, MI
55039,45,96,111,252,Fond du Lac County,55, WI
55013,36,221,111,368,Burnett County,55, WI
48443,232,40,111,383,Terrell County,48, TX
13135,114,116,111,341,Gwinnett County,13, GA
16015,234,190,111,535,Boise County,16, ID
15001,0,247,112,359,Hawaii County,15, HI
51840,112,91,112,315,Winchester city,51, VA
55025,126,46,112,284,Dane County,55, WI
29011,45,50,112,207,Barton County,29, MO
20165,25,40,112,177,Rush County,20, KS
51167,112,131,112,355,Russell County,51, VA
48331,177,153,112,442,Milam County,48, TX
26035,32,248,112,392,Clare County,26, MI
48297,227,170,112,509,Live Oak County,48, TX
40037,170,126,112,408,Creek County,40, OK
49033,245,13,112,370,Rich County,49, UT
13295,111,50,112,273,Walker County,13, GA
6059,254,215,113,582,Orange County,6, CA
51660,197,120,113,430,Harrisonburg city,51, VA
29143,59,91,113,263,New Madrid County,29, MO
1007,127,131,113,371,Bibb County,1, AL
41069,228,31,113,372,Wheeler County,41, OR
13075,176,43,113,332,Cook County,13, GA
20095,92,63,113,268,Kingman County,20, KS
16027,213,96,113,422,Canyon County,16, ID
1107,144,126,113,383,Pickens County,1, AL
55031,97,223,113,433,Douglas County,55, WI
17159,37,140,113,290,Richland County,17, IL
38025,148,40,113,301,Dunn County,38, ND
48411,229,63,114,406,San Saba County,48, TX
55095,21,158,114,293,Polk County,55, WI
22087,159,239,114,512,St. Bernard Parish,22, LA
5099,40,96,114,250,Nevada County,5, AR
42075,97,186,114,397,Lebanon County,42, PA
6011,241,254,114,609,Colusa County,6, CA
20003,30,27,114,171,Anderson County,20, KS
18131,9,106,114,229,Pulaski County,18, IN
29001,75,58,114,247,Adair County,29, MO
30003,202,162,114,478,Big Horn County,30, MT
30077,212,40,114,366,Powell County,30, MT
26073,15,205,114,334,Isabella County,26, MI
21213,4,158,115,277,Simpson County,21, KY
48399,194,50,115,359,Runnels County,48, TX
48189,132,140,115,387,Hale County,48, TX
20111,107,46,115,268,Lyon County,20, KS
8115,185,13,115,313,Sedgwick County,8, CO
30021,79,83,115,277,Dawson County,30, MT
25017,74,162,115,351,Middlesex County,25, MA
2130,0,231,115,346,Ketchikan Gateway Borough,2, AK
54095,122,240,115,477,Tyler County,54, WV
53047,202,220,115,537,Okanogan County,53, WA
53067,233,201,115,549,Thurston County,53, WA
1009,150,27,115,292,Blount County,1, AL
53011,240,207,116,563,Clark County,53, WA
38037,50,6,116,172,Grant County,38, ND
17035,20,87,116,223,Cumberland County,17, IL
23021,195,78,116,389,Piscataquis County,23, ME
37133,178,158,116,452,Onslow County,37, NC
29065,171,46,116,333,Dent County,29, MO
13007,132,101,116,349,Baker County,13, GA
53031,248,227,116,591,Jefferson County,53, WA
30017,77,46,116,239,Custer County,30, MT
51155,199,186,116,501,Pulaski County,51, VA
48505,223,250,116,589,Zapata County,48, TX
37137,188,83,116,387,Pamlico County,37, NC
40105,114,63,117,294,Nowata County,40, OK
26069,126,242,117,485,Iosco County,26, MI
9011,224,231,117,572,New London County,9, CT
51177,82,101,117,300,Spotsylvania County,51, VA
48477,204,83,117,404,Washington County,48, TX
53073,247,225,117,589,Whatcom County,53, WA
51053,67,120,117,304,Dinwiddie County,51, VA
13025,140,73,117,330,Brantley County,13, GA
33001,180,144,117,441,Belknap County,33, NH
29029,210,149,117,476,Camden County,29, MO
48047,115,243,117,475,Brooks County,48, TX
21101,94,106,117,317,Henderson County,21, KY
27145,19,87,118,224,Stearns County,27, MN
38059,68,58,118,244,Morton County,38, ND
8025,226,73,118,417,Crowley County,8, CO
16001,214,73,118,405,Ada County,16, ID
53041,234,227,118,579,Lewis County,53, WA
26125,50,225,118,393,Oakland County,26, MI
39101,4,174,118,296,Marion County,39, OH
49057,237,46,118,401,Weber County,49, UT
8119,251,170,118,539,Teller County,8, CO
17185,53,201,118,372,Wabash County,17, IL
26091,34,220,118,372,Lenawee County,26, MI
48373,213,212,118,543,Polk County,48, TX
5071,223,116,119,458,Johnson County,5, AR
46015,58,33,119,210,Brule County,46, SD
8075,199,43,119,361,Logan County,8, CO
46109,53,120,119,292,Roberts County,46, SD
40127,211,135,119,465,Pushmataha County,40, OK
54087,54,250,119,423,Roane County,54, WV
20033,69,14,119,202,Comanche County,20, KS
40099,201,110,119,430,Murray County,40, OK
42107,166,223,119,508,Schuylkill County,42, PA
47047,72,120,119,311,Fayette County,47, TN
17009,31,20,119,170,Brown County,17, IL
51007,59,91,119,269,Amelia County,51, VA
1115,203,50,120,373,St. Clair County,1, AL
26023,28,194,120,342,Branch County,26, MI
40081,144,83,120,347,Lincoln County,40, OK
40075,216,54,120,390,Kiowa County,40, OK
20053,125,11,120,256,Ellsworth County,20, KS
37123,202,135,120,457,Montgomery County,37, NC
47085,171,120,120,411,Humphreys County,47, TN
27115,21,209,120,350,Pine County,27, MN
48449,182,135,120,437,Titus County,48, TX
28047,188,229,120,537,Harrison County,28, MS
36039,156,201,120,477,Greene County,36, NY
20027,90,37,120,247,Clay County,20, KS
20031,82,63,121,266,Coffey County,20, KS
5065,204,205,121,530,Izard County,5, AR
29099,187,106,121,414,Jefferson County,29, MO
51515,203,0,121,324,Bedford city,51, VA
19177,76,40,121,237,Van Buren County,19, IA
48209,219,116,121,456,Hays County,48, TX
39019,137,215,121,473,Carroll County,39, OH
33017,130,116,121,367,Strafford County,33, NH
30081,208,91,121,420,Ravalli County,30, MT
42059,149,233,121,503,Greene County,42, PA
26005,105,162,121,388,Allegan County,26, MI
53061,243,207,121,571,Snohomish County,53, WA
13047,104,31,122,257,Catoosa County,13, GA
16073,218,101,122,441,Owyhee County,16, ID
21145,87,158,122,367,McCracken County,21, KY
39139,19,220,122,361,Richland County,39, OH
17109,13,153,122,288,McDonough County,17, IL
29055,119,120,122,361,Crawford County,29, MO
51111,38,67,122,227,Lunenburg County,51, VA
55059,108,153,122,383,Kenosha County,55, WI
27151,5,91,122,218,Swift County,27, MN
48079,128,153,122,403,Cochran County,48, TX
21217,164,101,122,387,Taylor County,21, KY
5145,88,110,122,320,White County,5, AR
37125,144,158,123,425,Moore County,37, NC
21117,55,91,123,269,Kenton County,21, KY
21227,97,131,123,351,Warren County,21, KY
6111,255,209,123,587,Ventura County,6, CA
38099,4,37,123,164,Walsh County,38, ND
29207,29,101,123,253,Stoddard County,29, MO
20121,73,54,123,250,Miami County,20, KS
20205,51,181,123,355,Wilson County,20, KS
40007,176,4,123,303,Beaver County,40, OK
19113,20,120,123,263,Linn County,19, IA
8007,249,174,123,546,Archuleta County,8, CO
4021,233,170,123,526,Pinal County,4, AZ
19123,49,46,124,219,Mahaska County,19, IA
53027,238,249,124,611,Grays Harbor County,53, WA
42125,161,227,124,512,Washington County,42, PA
20135,58,13,124,195,Ness County,20, KS
32021,249,83,124,456,Mineral County,32, NV
19017,14,22,124,160,Bremer County,19, IA
12041,195,50,124,369,Gilchrist County,12, FL
6109,252,241,124,617,Tuolumne County,6, CA
26137,86,240,124,450,Otsego County,26, MI
39119,162,181,124,467,Muskingum County,39, OH
36043,57,197,124,378,Herkimer County,36, NY
51183,75,207,124,406,Sussex County,51, VA
5083,211,131,125,467,Logan County,5, AR
37039,230,186,125,541,Cherokee County,37, NC
42095,134,220,125,479,Northampton County,42, PA
53057,244,234,125,603,Skagit County,53, WA
13019,156,91,125,372,Berrien County,13, GA
48015,202,131,125,458,Austin County,48, TX
21049,106,131,125,362,Clark County,21, KY
40021,223,73,125,421,Cherokee County,40, OK
48187,170,106,125,401,Guadalupe County,48, TX
1029,148,40,125,313,Cleburne County,1, AL
48147,149,43,125,317,Fannin County,48, TX
54007,104,241,125,470,Braxton County,54, WV
51049,60,106,126,292,Cumberland County,51, VA
45037,121,58,126,305,Edgefield County,45, SC
13193,104,135,126,365,Macon County,13, GA
19197,8,24,126,158,Wright County,19, IA
1037,208,78,126,412,Coosa County,1, AL
13227,207,46,126,379,Pickens County,13, GA
29053,131,83,126,340,Cooper County,29, MO
39141,75,190,126,391,Ross County,39, OH
55057,109,158,126,393,Juneau County,55, WI
24035,131,78,126,335,Queen Anne's County,24, MD
27039,1,73,126,200,Dodge County,27, MN
48391,225,197,126,548,Refugio County,48, TX
20075,101,0,127,228,Hamilton County,20, KS
26143,72,250,127,449,Roscommon County,26, MI
37057,130,153,127,410,Davidson County,37, NC
25007,229,223,127,579,Dukes County,25, MA
28091,139,153,127,419,Marion County,28, MS
16029,231,16,127,374,Caribou County,16, ID
13241,231,67,127,425,Rabun County,13, GA
26059,30,221,127,378,Hillsdale County,26, MI
5013,66,63,127,256,Calhoun County,5, AR
27127,6,78,127,211,Redwood County,27, MN
50011,118,67,127,312,Franklin County,50, VT
24027,63,63,127,253,Howard County,24, MD
5027,55,140,128,323,Columbia County,5, AR
55093,71,149,128,348,Pierce County,55, WI
36009,117,227,128,472,Cattaraugus County,36, NY
51001,194,126,128,448,Accomack County,51, VA
46013,22,33,128,183,Brown County,46, SD
48379,179,43,128,350,Rains County,48, TX
6041,254,135,128,517,Marin County,6, CA
55139,66,73,128,267,Winnebago County,55, WI
27071,2,166,128,296,Koochiching County,27, MN
16023,141,16,128,285,Butte County,16, ID
18043,78,126,128,332,Floyd County,18, IN
48145,157,101,128,386,Falls County,48, TX
31111,152,22,129,303,Lincoln County,31, NE
37163,55,91,129,275,Sampson County,37, NC
48103,201,252,129,582,Crane County,48, TX
48115,121,212,129,462,Dawson County,48, TX
36113,137,205,129,471,Warren County,36, NY
38041,49,24,129,202,Hettinger County,38, ND
29037,53,67,129,249,Cass County,29, MO
55113,63,186,129,378,Sawyer County,55, WI
56025,225,181,129,535,Natrona County,56, WY
40111,87,158,129,374,Okmulgee County,40, OK
29071,160,110,129,399,Franklin County,29, MO
30107,231,162,129,522,Wheatland County,30, MT
46101,17,67,130,214,Moody County,46, SD
39087,76,207,130,413,Lawrence County,39, OH
48207,217,31,130,378,Haskell County,48, TX
19135,32,63,130,225,Monroe County,19, IA
13311,207,33,130,370,White County,13, GA
32001,248,83,130,461,Churchill County,32, NV
16019,216,24,130,370,Bonneville County,16, ID
30031,238,54,130,422,Gallatin County,30, MT
21037,161,83,130,374,Campbell County,21, KY
1095,159,29,130,318,Marshall County,1, AL
48467,162,106,130,398,Van Zandt County,48, TX
39043,85,242,130,457,Erie County,39, OH
48031,239,20,131,390,Blanco County,48, TX
19067,3,101,131,235,Floyd County,19, IA
41011,248,209,131,588,Coos County,41, OR
48327,168,63,131,362,Menard County,48, TX
16047,179,20,131,330,Gooding County,16, ID
40091,195,205,131,531,McIntosh County,40, OK
26117,27,221,131,379,Montcalm County,26, MI
22057,143,126,131,400,Lafourche Parish,22, LA
33003,185,177,131,493,Carroll County,33, NH
6061,250,162,131,543,Placer County,6, CA
25021,98,201,131,430,Norfolk County,25, MA
49003,233,33,131,397,Box Elder County,49, UT
48099,188,131,132,451,Coryell County,48, TX
22103,179,140,132,451,St. Tammany Parish,22, LA
24031,102,116,132,350,Montgomery County,24, MD
39143,26,194,132,352,Sandusky County,39, OH
35055,240,248,132,620,Taos County,35, NM
51117,135,140,132,407,Mecklenburg County,51, VA
2261,0,212,132,344,Valdez-Cordova Census Area,2, AK
13151,104,166,132,402,Henry County,13, GA
42023,178,251,132,561,Cameron County,42, PA
37105,97,190,132,419,Lee County,37, NC
19035,23,20,132,175,Cherokee County,19, IA
8073,190,37,132,359,Lincoln County,8, CO
37143,167,135,133,435,Perquimans County,37, NC
20185,59,18,133,210,Stafford County,20, KS
31001,32,24,133,189,Adams County,31, NE
48281,228,73,133,434,Lampasas County,48, TX
48025,114,234,133,481,Bee County,48, TX
8107,248,186,133,567,Routt County,8, CO
5127,189,37,133,359,Scott County,5, AR
24013,67,58,133,258,Carroll County,24, MD
22011,62,135,133,330,Beauregard Parish,22, LA
17195,34,190,133,357,Whiteside County,17, IL
38101,43,101,133,277,Ward County,38, ND
49041,236,29,133,398,Sevier County,49, UT
2090,0,120,134,254,Fairbanks North Star Borough,2, AK
26007,141,177,134,452,Alpena County,26, MI
8067,249,140,134,523,La Plata County,8, CO
36059,179,205,134,518,Nassau County,36, NY
17181,170,194,134,498,Union County,17, IL
39085,110,205,134,449,Lake County,39, OH
8089,220,110,134,464,Otero County,8, CO
36045,69,212,134,415,Jefferson County,36, NY
42081,157,215,134,506,Lycoming County,42, PA
38061,66,58,134,258,Mountrail County,38, ND
46129,62,106,134,302,Walworth County,46, SD
17123,46,166,134,346,Marshall County,17, IL
4015,250,237,135,622,Mohave County,4, AZ
26109,56,120,135,311,Menominee County,26, MI
13293,202,131,135,468,Upson County,13, GA
48193,98,37,135,270,Hamilton County,48, TX
20147,145,13,135,293,Phillips County,20, KS
47027,199,194,135,528,Clay County,47, TN
13211,159,73,135,367,Morgan County,13, GA
37167,176,116,135,427,Stanly County,37, NC
40131,150,91,135,376,Rogers County,40, OK
56039,248,101,135,484,Teton County,56, WY
37101,73,116,135,324,Johnston County,37, NC
37023,213,158,135,506,Burke County,37, NC
17117,32,144,136,312,Macoupin County,17, IL
36011,62,186,136,384,Cayuga County,36, NY
48267,189,58,136,383,Kimble County,48, TX
5133,128,91,136,355,Sevier County,5, AR
13191,216,87,136,439,McIntosh County,13, GA
8003,208,120,136,464,Alamosa County,8, CO
31067,35,24,136,195,Gage County,31, NE
29225,108,67,136,311,Webster County,29, MO
29067,86,177,136,399,Douglas County,29, MO
1005,147,149,136,432,Barbour County,1, AL
51087,84,126,136,346,Henrico County,51, VA
47171,158,201,136,495,Unicoi County,47, TN
8085,229,131,137,497,Montrose County,8, CO
1117,192,22,137,351,Shelby County,1, AL
34025,174,215,137,526,Monmouth County,34, NJ
51790,128,116,137,381,Staunton city,51, VA
50021,114,144,137,395,Rutland County,50, VT
19029,50,22,137,209,Cass County,19, IA
40041,177,67,137,381,Delaware County,40, OK
48283,177,140,137,454,La Salle County,48, TX
28099,171,225,137,533,Neshoba County,28, MS
37089,216,144,137,497,Henderson County,37, NC
48093,158,78,137,373,Comanche County,48, TX
13265,128,158,137,423,Taliaferro County,13, GA
21173,74,190,138,402,Montgomery County,21, KY
17057,50,209,138,397,Fulton County,17, IL
37059,108,140,138,386,Davie County,37, NC
19065,3,78,138,219,Fayette County,19, IA
48083,219,166,138,523,Coleman County,48, TX
29059,124,96,138,358,Dallas County,29, MO
29007,29,96,138,263,Audrain County,29, MO
29221,183,158,138,479,Washington County,29, MO
40103,134,27,138,299,Noble County,40, OK
26055,159,205,138,502,Grand Traverse County,26, MI
18085,36,106,138,280,Kosciusko County,18, IN
26045,14,177,138,329,Eaton County,26, MI
48223,146,58,139,343,Hopkins County,48, TX
19147,35,40,139,214,Palo Alto County,19, IA
39059,170,212,139,521,Guernsey County,39, OH
48483,156,101,139,396,Wheeler County,48, TX
49027,227,10,139,376,Millard County,49, UT
55085,38,162,139,339,Oneida County,55, WI
53013,213,162,139,514,Columbia County,53, WA
29043,142,50,139,331,Christian County,29, MO
13031,147,126,139,412,Bulloch County,13, GA
55049,81,106,139,326,Iowa County,55, WI
38095,3,6,139,148,Towner County,38, ND
13139,187,43,139,369,Hall County,13, GA
51195,152,174,140,466,Wise County,51, VA
17051,44,170,140,354,Fayette County,17, IL
17083,53,166,140,359,Jersey County,17, IL
27067,24,46,140,210,Kandiyohi County,27, MN
48117,186,16,140,342,Deaf Smith County,48, TX
42091,104,174,140,418,Montgomery County,42, PA
18181,21,54,140,215,White County,18, IN
26139,134,140,140,414,Ottawa County,26, MI
21033,105,110,140,355,Caldwell County,21, KY
8037,242,229,140,611,Eagle County,8, CO
40149,118,135,140,393,Washita County,40, OK
48053,241,43,140,424,Burnet County,48, TX
44005,219,197,141,557,Newport County,44, RI
42061,145,241,141,527,Huntingdon County,42, PA
51037,60,83,141,284,Charlotte County,51, VA
20077,69,33,141,243,Harper County,20, KS
54063,65,153,141,359,Monroe County,54, WV
8023,244,158,141,543,Costilla County,8, CO
55063,96,73,141,310,La Crosse County,55, WI
48339,208,170,141,519,Montgomery County,48, TX
38093,50,14,141,205,Stutsman County,38, ND
49001,223,24,141,388,Beaver County,49, UT
19063,40,54,141,235,Emmet County,19, IA
20013,23,37,141,201,Brown County,20, KS
55117,113,87,142,342,Sheboygan County,55, WI
30079,112,140,142,394,Prairie County,30, MT
51083,169,149,142,460,Halifax County,51, VA
48317,185,106,142,433,Martin County,48, TX
47019,229,149,142,520,Carter County,47, TN
17145,72,227,142,441,Perry County,17, IL
21059,72,106,142,320,Daviess County,21, KY
8013,249,110,142,501,Boulder County,8, CO
29113,159,116,142,417,Lincoln County,29, MO
27109,4,73,142,219,Olmsted County,27, MN
36021,116,110,142,368,Columbia County,36, NY
48285,131,63,142,336,Lavaca County,48, TX
49053,225,67,143,435,Washington County,49, UT
29175,122,96,143,361,Randolph County,29, MO
18005,31,126,143,300,Bartholomew County,18, IN
23011,127,54,143,324,Kennebec County,23, ME
2122,0,221,143,364,Kenai Peninsula Borough,2, AK
51185,103,174,143,420,Tazewell County,51, VA
19151,17,14,143,174,Pocahontas County,19, IA
46117,127,22,143,292,Stanley County,46, SD
17197,30,229,143,402,Will County,17, IL
30071,154,50,143,347,Phillips County,30, MT
51810,194,110,143,447,Virginia Beach city,51, VA
49013,237,177,143,557,Duchesne County,49, UT
28035,135,190,144,469,Forrest County,28, MS
47057,205,158,144,507,Grainger County,47, TN
26135,66,249,144,459,Oscoda County,26, MI
18117,148,246,144,538,Orange County,18, IN
48325,176,116,144,436,Medina County,48, TX
38089,51,153,144,348,Stark County,38, ND
34023,102,212,144,458,Middlesex County,34, NJ
48023,210,14,144,368,Baylor County,48, TX
42071,164,170,144,478,Lancaster County,42, PA
26157,55,237,144,436,Tuscola County,26, MI
48255,202,116,144,462,Karnes County,48, TX
21019,154,201,144,499,Boyd County,21, KY
22075,155,149,145,449,Plaquemines Parish,22, LA
37151,136,166,145,447,Randolph County,37, NC
13077,119,110,145,374,Coweta County,13, GA
29005,92,24,145,261,Atchison County,29, MO
51131,199,181,145,525,Northampton County,51, VA
51135,57,58,145,260,Nottoway County,51, VA
27083,22,37,145,204,Lyon County,27, MN
42099,108,140,145,393,Perry County,42, PA
51510,36,101,145,282,Alexandria city,51, VA
18091,47,229,145,421,LaPorte County,18, IN
29033,127,101,145,373,Carroll County,29, MO
40087,174,78,145,397,McClain County,40, OK
8065,254,197,146,597,Lake County,8, CO
22001,58,162,146,366,Acadia Parish,22, LA
26103,76,201,146,423,Marquette County,26, MI
36099,76,197,146,419,Seneca County,36, NY
21151,130,101,146,377,Madison County,21, KY
13119,106,96,146,348,Franklin County,13, GA
55067,14,126,146,286,Langlade County,55, WI
21113,43,83,146,272,Jessamine County,21, KY
56013,237,110,146,493,Fremont County,56, WY
29131,181,110,146,437,Miller County,29, MO
13055,76,205,146,427,Chattooga County,13, GA
40139,217,2,146,365,Texas County,40, OK
17089,21,221,147,389,Kane County,17, IL
13029,176,67,147,390,Bryan County,13, GA
13001,140,43,147,330,Appling County,13, GA
36075,122,218,147,487,Oswego County,36, NY
18107,11,63,147,221,Montgomery County,18, IN
37111,220,149,147,516,McDowell County,37, NC
42029,59,120,147,326,Chester County,42, PA
56019,228,78,147,453,Johnson County,56, WY
5129,197,120,147,464,Searcy County,5, AR
19061,91,96,147,334,Dubuque County,19, IA
29205,35,37,147,219,Shelby County,29, MO
16045,224,96,147,467,Gem County,16, ID
40107,157,131,148,436,Okfuskee County,40, OK
48121,203,126,148,477,Denton County,48, TX
48013,184,205,148,537,Atascosa County,48, TX
55087,11,78,148,237,Outagamie County,55, WI
28105,100,174,148,422,Oktibbeha County,28, MS
51027,56,229,148,433,Buchanan County,51, VA
19099,13,67,148,228,Jasper County,19, IA
26013,104,249,148,501,Baraga County,26, MI
40009,111,170,148,429,Beckham County,40, OK
18027,52,20,148,220,Daviess County,18, IN
12089,217,87,148,452,Nassau County,12, FL
27035,39,158,148,345,Crow Wing County,27, MN
37027,206,186,149,541,Caldwell County,37, NC
55035,14,78,149,241,Eau Claire County,55, WI
19055,9,24,149,182,Delaware County,19, IA
51161,137,58,149,344,Roanoke County,51, VA
39045,126,131,149,406,Fairfield County,39, OH
54085,30,205,149,384,Ritchie County,54, WV
49043,244,158,149,551,Summit County,49, UT
34015,100,225,149,474,Gloucester County,34, NJ
26087,40,251,149,440,Lapeer County,26, MI
29057,186,33,149,368,Dade County,29, MO
19097,88,106,149,343,Jackson County,19, IA
17147,2,73,149,224,Piatt County,17, IL
26131,94,240,150,484,Ontonagon County,26, MI
36101,92,197,150,439,Steuben County,36, NY
51029,117,166,150,433,Buckingham County,51, VA
26003,85,243,150,478,Alger County,26, MI
30105,135,31,150,316,Valley County,30, MT
41067,227,126,150,503,Washington County,41, OR
27023,10,58,150,218,Chippewa County,27, MN
48033,223,11,150,384,Borden County,48, TX
53019,221,248,150,619,Ferry County,53, WA
55069,17,96,150,263,Lincoln County,55, WI
53007,207,205,150,562,Chelan County,53, WA
13195,77,63,150,290,Madison County,13, GA
48155,139,29,151,319,Foard County,48, TX
13023,145,126,151,422,Bleckley County,13, GA
42087,125,205,151,481,Mifflin County,42, PA
13183,134,33,151,318,Long County,13, GA
26071,19,194,151,364,Iron County,26, MI
39047,13,166,151,330,Fayette County,39, OH
6105,239,190,151,580,Trinity County,6, CA
12077,158,46,151,355,Liberty County,12, FL
26015,39,166,151,356,Barry County,26, MI
20073,175,63,151,389,Greenwood County,20, KS
28011,102,212,151,465,Bolivar County,28, MS
37037,162,73,151,386,Chatham County,37, NC
42129,184,221,152,557,Westmoreland County,42, PA
48151,155,37,152,344,Fisher County,48, TX
50003,90,131,152,373,Bennington County,50, VT
22125,120,73,152,345,West Feliciana Parish,22, LA
8097,251,242,152,645,Pitkin County,8, CO
16069,203,50,152,405,Nez Perce County,16, ID
37161,164,225,152,541,Rutherford County,37, NC
36087,179,194,152,525,Rockland County,36, NY
26011,78,247,152,477,Arenac County,26, MI
13263,191,144,152,487,Talbot County,13, GA
30059,228,43,152,423,Meagher County,30, MT
54089,175,181,152,508,Summers County,54, WV
36037,18,166,153,337,Genesee County,36, NY
36111,176,190,153,519,Ulster County,36, NY
40069,210,177,153,540,Johnston County,40, OK
8099,193,33,153,379,Prowers County,8, CO
20153,60,3,153,216,Rawlins County,20, KS
48191,153,91,153,397,Hall County,48, TX
2100,0,254,153,407,Haines Borough,2, AK
13131,146,33,153,332,Grady County,13, GA
26009,170,233,153,556,Antrim County,26, MI
31051,52,10,153,215,Dixon County,31, NE
19133,79,46,153,278,Monona County,19, IA
48199,189,220,154,563,Hardin County,48, TX
13289,129,166,154,449,Twiggs County,13, GA
42031,118,197,154,469,Clarion County,42, PA
48225,143,67,154,364,Houston County,48, TX
48119,101,78,154,333,Delta County,48, TX
8105,247,153,154,554,Rio Grande County,8, CO
26127,153,240,154,547,Oceana County,26, MI
29135,161,29,154,344,Moniteau County,29, MO
37015,118,120,154,392,Bertie County,37, NC
12113,215,63,154,432,Santa Rosa County,12, FL
1083,110,31,154,295,Limestone County,1, AL
37135,65,73,154,292,Orange County,37, NC
37053,184,116,155,455,Currituck County,37, NC
46115,7,27,155,189,Spink County,46, SD
33019,126,73,155,354,Sullivan County,33, NH
17097,118,194,155,467,Lake County,17, IL
19175,48,96,155,299,Union County,19, IA
28033,121,101,155,377,DeSoto County,28, MS
34005,68,197,155,420,Burlington County,34, NJ
16063,110,91,155,356,Lincoln County,16, ID
29139,117,54,155,326,Montgomery County,29, MO
13223,163,73,155,391,Paulding County,13, GA
27085,18,87,155,260,McLeod County,27, MN
48265,242,96,155,493,Kerr County,48, TX
18075,4,131,156,291,Jay County,18, IN
20117,65,9,156,230,Marshall County,20, KS
16057,193,43,156,392,Latah County,16, ID
20085,19,73,156,248,Jackson County,20, KS
20091,53,58,156,267,Johnson County,20, KS
36073,101,205,156,462,Orleans County,36, NY
28127,90,140,156,386,Simpson County,28, MS
13157,72,33,156,261,Jackson County,13, GA
18053,8,116,156,280,Grant County,18, IN
51175,83,54,156,293,Southampton County,51, VA
30045,214,50,156,420,Judith Basin County,30, MT
20113,49,14,156,219,McPherson County,20, KS
27113,1,110,157,268,Pennington County,27, MN
51047,73,54,157,284,Culpeper County,51, VA
48095,221,37,157,415,Concho County,48, TX
39149,29,177,157,363,Shelby County,39, OH
41061,202,181,157,540,Union County,41, OR
16011,214,22,157,393,Bingham County,16, ID
20041,82,50,157,289,Dickinson County,20, KS
48039,200,209,157,566,Brazoria County,48, TX
27153,19,67,157,243,Todd County,27, MN
29073,165,91,157,413,Gasconade County,29, MO
48085,188,116,157,461,Collin County,48, TX
19125,35,29,157,221,Marion County,19, IA
53051,233,243,158,634,Pend Oreille County,53, WA
48503,168,67,158,393,Young County,48, TX
19095,5,33,158,196,Iowa County,19, IA
55043,108,67,158,333,Grant County,55, WI
51153,83,126,158,367,Prince William County,51, VA
29157,221,87,158,466,Perry County,29, MO
42065,84,215,158,457,Jefferson County,42, PA
50007,142,46,158,346,Chittenden County,50, VT
55129,35,144,158,337,Washburn County,55, WI
37019,192,215,158,565,Brunswick County,37, NC
8057,251,31,158,440,Jackson County,8, CO
55021,105,96,158,359,Columbia County,55, WI
5049,168,58,159,385,Fulton County,5, AR
48497,183,126,159,468,Wise County,48, TX
42015,154,170,159,483,Bradford County,42, PA
41009,245,186,159,590,Columbia County,41, OR
37175,223,106,159,488,Transylvania County,37, NC
40055,178,166,159,503,Greer County,40, OK
18051,58,110,159,327,Gibson County,18, IN
16031,212,18,159,389,Cassia County,16, ID
26029,186,234,159,579,Charlevoix County,26, MI
51173,58,120,159,337,Smyth County,51, VA
48313,149,158,159,466,Madison County,48, TX
21141,93,78,159,330,Logan County,21, KY
35007,237,153,160,550,Colfax County,35, NM
29079,102,40,160,302,Grundy County,29, MO
48403,218,244,160,622,Sabine County,48, TX
21161,161,190,160,511,Mason County,21, KY
19049,25,16,160,201,Dallas County,19, IA
13207,193,58,160,411,Monroe County,13, GA
8111,253,135,160,548,San Juan County,8, CO
50005,73,91,160,324,Caledonia County,50, VT
56017,191,54,160,405,Hot Springs County,56, WY
22053,78,170,160,408,Jefferson Davis Parish,22, LA
48143,139,87,160,386,Erath County,48, TX
23031,183,73,160,416,York County,23, ME
41059,209,140,161,510,Umatilla County,41, OR
28019,126,120,161,407,Choctaw County,28, MS
48491,185,96,161,442,Williamson County,48, TX
51081,91,140,161,392,Greensville County,51, VA
48139,151,101,161,413,Ellis County,48, TX
42105,30,225,161,416,Potter County,42, PA
54065,162,101,161,424,Morgan County,54, WV
19169,8,16,161,185,Story County,19, IA
17085,111,201,161,473,Jo Daviess County,17, IL
27009,10,131,161,302,Benton County,27, MN
16059,163,135,161,459,Lemhi County,16, ID
51179,128,87,161,376,Stafford County,51, VA
16077,217,27,162,406,Power County,16, ID
28115,108,181,162,451,Pontotoc County,28, MS
53029,234,201,162,597,Island County,53, WA
27049,65,96,162,323,Goodhue County,27, MN
12119,228,186,162,576,Sumter County,12, FL
29195,80,37,162,279,Saline County,29, MO
20197,161,29,162,352,Wabaunsee County,20, KS
19115,48,54,162,264,Louisa County,19, IA
31149,77,1,162,240,Rock County,31, NE
21107,123,166,162,451,Hopkins County,21, KY
41065,234,153,162,549,Wasco County,41, OR
23001,117,78,162,357,Androscoggin County,23, ME
41049,233,63,163,459,Morrow County,41, OR
29101,43,87,163,293,Johnson County,29, MO
36103,206,207,163,576,Suffolk County,36, NY
21075,108,126,163,397,Fulton County,21, KY
13137,196,73,163,432,Habersham County,13, GA
20019,150,106,163,419,Chautauqua County,20, KS
46023,70,116,163,349,Charles Mix County,46, SD
48429,202,106,163,471,Stephens County,48, TX
26057,4,190,163,357,Gratiot County,26, MI
48017,185,46,163,394,Bailey County,48, TX
8061,221,2,163,386,Kiowa County,8, CO
21097,52,106,163,321,Harrison County,21, KY
42055,102,174,164,440,Franklin County,42, PA
16035,222,197,164,583,Clearwater County,16, ID
50019,142,186,164,492,Orleans County,50, VT
21013,144,181,164,489,Bell County,21, KY
21015,154,73,164,391,Boone County,21, KY
48051,203,116,164,483,Burleson County,48, TX
27001,51,194,164,409,Aitkin County,27, MN
39145,82,212,164,458,Scioto County,39, OH
22095,115,246,164,525,St. John the Baptist Parish,22, LA
55111,79,170,164,413,Sauk County,55, WI
13281,232,135,164,531,Towns County,13, GA
40077,184,237,164,585,Latimer County,40, OK
51105,66,120,165,351,Lee County,51, VA
21083,27,96,165,288,Graves County,21, KY
21239,42,54,165,261,Woodford County,21, KY
36117,106,166,165,437,Wayne County,36, NY
48009,116,67,165,348,Archer County,48, TX
29183,183,63,165,411,St. Charles County,29, MO
17011,16,174,165,355,Bureau County,17, IL
27003,30,116,165,311,Anoka County,27, MN
48465,247,186,165,598,Val Verde County,48, TX
19083,7,40,165,212,Hardin County,19, IA
36069,97,162,165,424,Ontario County,36, NY
51093,168,58,165,391,Isle of Wight County,51, VA
36003,85,194,166,445,Allegany County,36, NY
33005,153,106,166,425,Cheshire County,33, NH
39093,116,236,166,518,Lorain County,39, OH
36025,158,158,166,482,Delaware County,36, NY
18007,1,63,166,230,Benton County,18, IN
20025,149,1,166,316,Clark County,20, KS
26027,39,215,166,420,Cass County,26, MI
37079,33,83,166,282,Greene County,37, NC
16049,232,135,166,533,Idaho County,16, ID
55071,113,110,166,389,Manitowoc County,55, WI
40029,184,131,166,481,Coal County,40, OK
48387,129,120,166,415,Red River County,48, TX
1065,204,227,167,598,Hale County,1, AL
12013,192,63,167,422,Calhoun County,12, FL
29017,166,83,167,416,Bollinger County,29, MO
48389,228,153,167,548,Reeves County,48, TX
13049,114,20,167,301,Charlton County,13, GA
8009,166,2,167,335,Baca County,8, CO
51013,36,37,167,240,Arlington County,51, VA
39037,12,135,167,314,Darke County,39, OH
37011,215,116,167,498,Avery County,37, NC
27131,37,63,167,267,Rice County,27, MN
27027,2,31,167,200,Clay County,27, MN
41019,252,177,167,596,Douglas County,41, OR
18125,51,96,168,315,Pike County,18, IN
48175,208,177,168,553,Goliad County,48, TX
28147,87,205,168,460,Walthall County,28, MS
55033,58,78,168,304,Dunn County,55, WI
40129,119,46,168,333,Roger Mills County,40, OK
23029,227,110,168,505,Washington County,23, ME
1075,88,50,168,306,Lamar County,1, AL
40085,201,29,168,398,Love County,40, OK
21183,123,158,168,449,Ohio County,21, KY
48337,102,131,168,401,Montague County,48, TX
2220,0,144,168,312,Sitka City and Borough,2, AK
36077,92,158,168,418,Otsego County,36, NY
21221,188,144,169,501,Trigg County,21, KY
23005,190,67,169,426,Cumberland County,23, ME
48275,172,83,169,424,Knox County,48, TX
26067,16,186,169,371,Ionia County,26, MI
27017,39,158,169,366,Carlton County,27, MN
46081,211,110,169,490,Lawrence County,46, SD
26001,158,236,169,563,Alcona County,26, MI
28057,188,149,169,506,Itawamba County,28, MS
18165,34,170,169,373,Vermillion County,18, IN
8103,235,73,169,477,Rio Blanco County,8, CO
48307,223,170,169,562,McCulloch County,48, TX
48455,205,194,169,568,Trinity County,48, TX
30089,222,181,170,573,Sanders County,30, MT
42111,137,229,170,536,Somerset County,42, PA
55107,34,131,170,335,Rusk County,55, WI
37109,206,131,170,507,Lincoln County,37, NC
51830,193,197,170,560,Williamsburg city,51, VA
55017,32,110,170,312,Chippewa County,55, WI
29087,127,13,170,310,Holt County,29, MO
20141,76,7,170,253,Osborne County,20, KS
36023,58,186,170,414,Cortland County,36, NY
38039,14,9,170,193,Griggs County,38, ND
26037,9,131,170,310,Clinton County,26, MI
29045,105,101,170,376,Clark County,29, MO
51685,83,140,171,394,Manassas Park city,51, VA
37189,213,110,171,494,Watauga County,37, NC
38071,15,37,171,223,Ramsey County,38, ND
50023,99,46,171,316,Washington County,50, VT
5077,110,170,171,451,Lee County,5, AR
8081,239,101,171,511,Moffat County,8, CO
47187,87,46,171,304,Williamson County,47, TN
33013,138,91,171,400,Merrimack County,33, NH
39071,60,212,171,443,Highland County,39, OH
5075,130,106,171,407,Lawrence County,5, AR
38063,6,37,171,214,Nelson County,38, ND
54093,119,207,171,497,Tucker County,54, WV
8117,254,234,172,660,Summit County,8, CO
55015,60,43,172,275,Calumet County,55, WI
21211,95,78,172,345,Shelby County,21, KY
30073,234,50,172,456,Pondera County,30, MT
56005,180,144,172,496,Campbell County,56, WY
48221,201,131,172,504,Hood County,48, TX
31047,170,13,172,355,Dawson County,31, NE
42121,87,218,172,477,Venango County,42, PA
20131,7,8,172,187,Nemaha County,20, KS
23007,146,106,172,424,Franklin County,23, ME
18069,33,131,172,336,Huntington County,18, IN
42115,152,162,172,486,Susquehanna County,42, PA
54041,81,245,173,499,Lewis County,54, WV
20199,62,1,173,236,Wallace County,20, KS
21035,101,110,173,384,Calloway County,21, KY
48163,161,87,173,421,Frio County,48, TX
42037,133,194,173,500,Columbia County,42, PA
51147,54,126,173,353,Prince Edward County,51, VA
24009,174,63,173,410,Calvert County,24, MD
49037,235,239,173,647,San Juan County,49, UT
29089,154,27,173,354,Howard County,29, MO
26047,185,242,173,600,Emmet County,26, MI
17027,94,91,173,358,Clinton County,17, IL
13309,141,158,173,472,Wheeler County,13, GA
41071,232,140,174,546,Yamhill County,41, OR
19093,39,16,174,229,Ida County,19, IA
51041,88,96,174,358,Chesterfield County,51, VA
51139,186,162,174,522,Page County,51, VA
23025,165,131,174,470,Somerset County,23, ME
18031,15,170,174,359,Decatur County,18, IN
55007,103,225,174,502,Bayfield County,55, WI
56003,225,54,174,453,Big Horn County,56, WY
13243,107,96,174,377,Randolph County,13, GA
8071,235,166,174,575,Las Animas County,8, CO
22045,166,227,174,567,Iberia Parish,22, LA
26063,94,207,174,475,Huron County,26, MI
48235,143,101,175,419,Irion County,48, TX
29211,57,31,175,263,Sullivan County,29, MO
8093,252,87,175,514,Park County,8, CO
40043,146,46,175,367,Dewey County,40, OK
51199,198,83,175,456,York County,51, VA
42103,197,242,175,614,Pike County,42, PA
44003,199,212,175,586,Kent County,44, RI
48239,135,91,175,401,Jackson County,48, TX
17093,19,205,175,399,Kendall County,17, IL
48499,202,131,175,508,Wood County,48, TX
51033,71,135,175,381,Caroline County,51, VA
42057,72,248,175,495,Fulton County,42, PA
42035,165,212,176,553,Clinton County,42, PA
17021,38,194,176,408,Christian County,17, IL
17073,10,181,176,367,Henry County,17, IL
48501,148,249,176,573,Yoakum County,48, TX
8045,238,140,176,554,Garfield County,8, CO
21157,121,106,176,403,Marshall County,21, KY
36115,98,158,176,432,Washington County,36, NY
27167,0,27,176,203,Wilkin County,27, MN
20127,111,22,176,309,Morris County,20, KS
55055,55,73,176,304,Jefferson County,55, WI
55073,12,54,176,242,Marathon County,55, WI
37177,175,218,176,569,Tyrrell County,37, NC
51121,153,46,177,376,Montgomery County,51, VA
33009,156,91,177,424,Grafton County,33, NH
26111,15,170,177,362,Midland County,26, MI
36031,120,194,177,491,Essex County,36, NY
29117,42,20,177,239,Livingston County,29, MO
51109,97,63,177,337,Louisa County,51, VA
36121,22,170,177,369,Wyoming County,36, NY
29147,19,40,177,236,Nodaway County,29, MO
23015,207,67,177,451,Lincoln County,23, ME
42127,163,223,177,563,Wayne County,42, PA
21235,193,153,177,523,Whitley County,21, KY
51191,122,91,177,390,Washington County,51, VA
21007,104,131,178,413,Ballard County,21, KY
13109,154,58,178,390,Evans County,13, GA
40045,192,37,178,407,Ellis County,40, OK
51141,198,144,178,520,Patrick County,51, VA
40003,126,16,178,320,Alfalfa County,40, OK
5005,226,96,178,500,Baxter County,5, AR
56035,248,158,178,584,Sublette County,56, WY
31043,50,46,178,274,Dakota County,31, NE
19195,8,73,178,259,Worth County,19, IA
41027,242,116,178,536,Hood River County,41, OR
54023,205,126,178,509,Grant County,54, WV
54015,106,251,178,535,Clay County,54, WV
21199,171,162,179,512,Pulaski County,21, KY
51043,51,37,179,267,Clarke County,51, VA
48059,157,73,179,409,Callahan County,48, TX
16067,203,20,179,402,Minidoka County,16, ID
56027,136,20,179,335,Niobrara County,56, WY
33015,157,153,179,489,Rockingham County,33, NH
40133,170,166,179,515,Seminole County,40, OK
46059,13,4,179,196,Hand County,46, SD
13249,63,31,179,273,Schley County,13, GA
41043,236,181,179,596,Linn County,41, OR
37029,162,78,179,419,Camden County,37, NC
51015,128,40,179,347,Augusta County,51, VA
51031,112,96,180,388,Campbell County,51, VA
56001,244,24,180,448,Albany County,56, WY
55127,28,106,180,314,Walworth County,55, WI
13219,78,20,180,278,Oconee County,13, GA
27037,16,110,180,306,Dakota County,27, MN
54103,85,234,180,499,Wetzel County,54, WV
40093,60,43,180,283,Major County,40, OK
51171,92,67,180,339,Shenandoah County,51, VA
21029,87,120,180,387,Bullitt County,21, KY
28159,166,212,180,558,Winston County,28, MS
53049,244,243,180,667,Pacific County,53, WA
27093,23,63,180,266,Meeker County,27, MN
8027,249,54,181,484,Custer County,8, CO
13319,207,73,181,461,Wilkinson County,13, GA
39057,44,120,181,345,Greene County,39, OH
18149,19,190,181,390,Starke County,18, IN
27047,31,83,181,295,Freeborn County,27, MN
18103,20,197,181,398,Miami County,18, IN
54037,74,96,181,351,Jefferson County,54, WV
21009,61,170,181,412,Barren County,21, KY
39063,24,140,181,345,Hancock County,39, OH
16043,229,16,181,426,Fremont County,16, ID
27105,27,29,181,237,Nobles County,27, MN
41055,208,106,181,495,Sherman County,41, OR
21093,96,153,182,431,Hardin County,21, KY
28017,81,245,182,508,Chickasaw County,28, MS
53059,134,223,182,539,Skamania County,53, WA
27161,32,110,182,324,Waseca County,27, MN
51045,101,58,182,341,Craig County,51, VA
36017,64,144,182,390,Chenango County,36, NY
19137,54,43,182,279,Montgomery County,19, IA
53039,216,197,182,595,Klickitat County,53, WA
21017,14,96,182,292,Bourbon County,21, KY
19033,17,63,182,262,Cerro Gordo County,19, IA
18099,30,120,182,332,Marshall County,18, IN
48367,145,96,182,423,Parker County,48, TX
29081,72,37,183,292,Harrison County,29, MO
54053,133,207,183,523,Mason County,54, WV
36057,24,215,183,422,Montgomery County,36, NY
5079,70,101,183,354,Lincoln County,5, AR
19069,2,20,183,205,Franklin County,19, IA
36097,135,209,183,527,Schuyler County,36, NY
23017,198,135,183,516,Oxford County,23, ME
4023,250,247,183,680,Santa Cruz County,4, AZ
13145,147,40,183,370,Harris County,13, GA
42019,121,186,183,490,Butler County,42, PA
42117,121,220,183,524,Tioga County,42, PA
27149,12,11,183,206,Stevens County,27, MN
26113,45,221,184,450,Missaukee County,26, MI
30043,221,58,184,463,Jefferson County,30, MT
51127,151,40,184,375,New Kent County,51, VA
27043,18,110,184,312,Faribault County,27, MN
53037,233,220,184,637,Kittitas County,53, WA
32005,253,209,184,646,Douglas County,32, NV
50027,145,67,184,396,Windsor County,50, VT
55001,29,229,184,442,Adams County,55, WI
42001,128,144,184,456,Adams County,42, PA
21179,99,144,184,427,Nelson County,21, KY
37113,233,135,184,552,Macon County,37, NC
39129,37,140,184,361,Pickaway County,39, OH
31127,47,16,185,248,Nemaha County,31, NE
30019,5,6,185,196,Daniels County,30, MT
48019,249,91,185,525,Bandera County,48, TX
51085,41,46,185,272,Hanover County,51, VA
20023,127,1,185,313,Cheyenne County,20, KS
29035,196,126,185,507,Carter County,29, MO
37025,76,149,185,410,Cabarrus County,37, NC
37003,194,166,185,545,Alexander County,37, NC
48165,182,83,185,450,Gaines County,48, TX
55137,24,116,185,325,Waushara County,55, WI
41003,231,83,185,499,Benton County,41, OR
36089,40,197,185,422,St. Lawrence County,36, NY
21159,84,248,186,518,Martin County,21, KY
31019,139,24,186,349,Buffalo County,31, NE
48369,215,3,186,404,Parmer County,48, TX
31045,112,6,186,304,Dawes County,31, NE
20159,55,29,186,270,Rice County,20, KS
51069,112,40,186,338,Frederick County,51, VA
37115,215,144,186,545,Madison County,37, NC
27139,17,96,186,299,Scott County,27, MN
19161,62,14,186,262,Sac County,19, IA
46123,36,9,186,231,Tripp County,46, SD
30097,232,16,186,434,Sweet Grass County,30, MT
55135,27,78,186,291,Waupaca County,55, WI
26031,142,253,187,582,Cheboygan County,26, MI
19031,12,33,187,232,Cedar County,19, IA
27141,19,106,187,312,Sherburne County,27, MN
27159,5,174,187,366,Wadena County,27, MN
48259,243,54,187,484,Kendall County,48, TX
31137,37,8,187,232,Phelps County,31, NE
20063,50,7,187,244,Gove County,20, KS
51067,215,78,187,480,Franklin County,51, VA
18175,39,144,187,370,Washington County,18, IN
51193,152,96,187,435,Westmoreland County,51, VA
27165,19,40,187,246,Watonwan County,27, MN
39091,65,201,187,453,Logan County,39, OH
48043,242,135,188,565,Brewster County,48, TX
46125,9,22,188,219,Turner County,46, SD
51735,198,29,188,415,Poquoson city,51, VA
53075,220,96,188,504,Whitman County,53, WA
19039,30,73,188,291,Clarke County,19, IA
38003,20,22,188,230,Barnes County,38, ND
26053,53,177,188,418,Gogebic County,26, MI
36019,115,190,188,493,Clinton County,36, NY
55053,87,225,188,500,Jackson County,55, WI
33007,130,186,188,504,Coos County,33, NH
21077,173,101,188,462,Gallatin County,21, KY
8017,134,2,188,324,Cheyenne County,8, CO
51077,195,87,189,471,Grayson County,51, VA
39163,98,221,189,508,Vinton County,39, OH
29047,145,106,189,440,Clay County,29, MO
54009,160,220,189,569,Brooke County,54, WV
37093,69,212,189,470,Hoke County,37, NC
51005,212,126,189,527,Alleghany County,51, VA
55097,26,73,189,288,Portage County,55, WI
18127,104,194,189,487,Porter County,18, IN
8029,236,131,189,556,Delta County,8, CO
17049,20,131,189,340,Effingham County,17, IL
48305,200,73,189,462,Lynn County,48, TX
17111,30,201,189,420,McHenry County,17, IL
29123,188,126,190,504,Madison County,29, MO
29223,219,106,190,515,Wayne County,29, MO
34029,175,229,190,594,Ocean County,34, NJ
2060,0,166,190,356,Bristol Bay Borough,2, AK
41005,236,158,190,584,Clackamas County,41, OR
31151,16,16,190,222,Saline County,31, NE
51003,135,73,190,398,Albemarle County,51, VA
54021,23,237,190,450,Gilmer County,54, WV
20157,56,11,190,257,Republic County,20, KS
28085,81,162,190,433,Lincoln County,28, MS
17099,21,227,190,438,LaSalle County,17, IL
29107,52,67,190,309,Lafayette County,29, MO
37009,221,110,191,522,Ashe County,37, NC
27081,38,33,191,262,Lincoln County,27, MN
30015,81,22,191,294,Chouteau County,30, MT
29137,83,96,191,370,Monroe County,29, MO
20083,83,4,191,278,Hodgeman County,20, KS
42017,137,201,191,529,Bucks County,42, PA
18159,0,106,191,297,Tipton County,18, IN
51197,143,177,191,511,Wythe County,51, VA
48397,203,101,191,495,Rockwall County,48, TX
55081,66,78,191,335,Monroe County,55, WI
51125,158,83,191,432,Nelson County,51, VA
16021,226,110,191,527,Boundary County,16, ID
53065,225,227,192,644,Stevens County,53, WA
19167,6,4,192,202,Sioux County,19, IA
48493,163,87,192,442,Wilson County,48, TX
51079,109,63,192,364,Greene County,51, VA
16017,242,170,192,604,Bonner County,16, ID
29165,144,73,192,409,Platte County,29, MO
27111,30,73,192,295,Otter Tail County,27, MN
48149,189,43,192,424,Fayette County,48, TX
55005,19,106,192,317,Barron County,55, WI
20195,180,14,192,386,Trego County,20, KS
21041,159,96,192,447,Carroll County,21, KY
17157,173,153,192,518,Randolph County,17, IL
27051,22,67,193,282,Grant County,27, MN
31029,61,0,193,254,Chase County,31, NE
42131,176,205,193,574,Wyoming County,42, PA
31145,50,11,193,254,Red Willow County,31, NE
20069,82,1,193,276,Gray County,20, KS
48069,196,16,193,405,Castro County,48, TX
51720,152,170,193,515,Norton city,51, VA
51095,193,144,193,530,James City County,51, VA
40083,120,58,193,371,Logan County,40, OK
53017,162,207,193,562,Douglas County,53, WA
36033,99,197,193,489,Franklin County,36, NY
17177,5,162,193,360,Stephenson County,17, IL
47137,210,106,194,510,Pickett County,47, TN
51097,128,58,194,380,King and Queen County,51, VA
18063,7,54,194,255,Hendricks County,18, IN
27091,27,63,194,284,Martin County,27, MN
42027,111,91,194,396,Centre County,42, PA
17103,18,140,194,352,Lee County,17, IL
29215,164,91,194,449,Texas County,29, MO
38067,0,91,194,285,Pembina County,38, ND
51169,107,67,194,368,Scott County,51, VA
36035,121,209,194,524,Fulton County,36, NY
42005,158,234,194,586,Armstrong County,42, PA
1023,185,135,194,514,Choctaw County,1, AL
30087,115,87,195,397,Rosebud County,30, MT
21193,125,218,195,538,Perry County,21, KY
21085,148,181,195,524,Grayson County,21, KY
39069,22,194,195,411,Henry County,39, OH
46095,92,110,195,397,Mellette County,46, SD
21001,151,158,195,504,Adair County,21, KY
21191,94,63,195,352,Pendleton County,21, KY
21219,81,46,195,322,Todd County,21, KY
16025,227,46,195,468,Camas County,16, ID
4001,234,251,195,680,Apache County,4, AZ
54017,26,116,195,337,Doddridge County,54, WV
29227,58,29,195,282,Worth County,29, MO
51187,191,91,196,478,Warren County,51, VA
5117,87,67,196,350,Prairie County,5, AR
40035,60,73,196,329,Craig County,40, OK
28027,98,251,196,545,Coahoma County,28, MS
48359,195,22,196,413,Oldham County,48, TX
51073,198,73,196,467,Gloucester County,51, VA
28097,140,190,196,526,Montgomery County,28, MS
39053,79,190,196,465,Gallia County,39, OH
31025,40,31,196,267,Cass County,31, NE
17043,33,186,196,415,DuPage County,17, IL
39007,84,201,196,481,Ashtabula County,39, OH
17169,41,110,196,347,Schuyler County,17, IL
22003,31,223,197,451,Allen Parish,22, LA
56033,219,50,197,466,Sheridan County,56, WY
27103,25,46,197,268,Nicollet County,27, MN
5135,166,153,197,516,Sharp County,5, AR
48159,179,67,197,443,Franklin County,48, TX
21167,135,162,197,494,Mercer County,21, KY
21051,61,209,197,467,Clay County,21, KY
40005,232,149,197,578,Atoka County,40, OK
39135,44,135,197,376,Preble County,39, OH
46071,93,31,197,321,Jackson County,46, SD
34003,195,231,197,623,Bergen County,34, NJ
27147,16,78,197,291,Steele County,27, MN
28007,138,201,198,537,Attala County,28, MS
38057,56,91,198,345,Mercer County,38, ND
27041,37,46,198,281,Douglas County,27, MN
42039,43,218,198,459,Crawford County,42, PA
28089,136,131,198,465,Madison County,28, MS
54025,124,194,198,516,Greenbrier County,54, WV
51099,126,37,198,361,King George County,51, VA
27057,13,153,198,364,Hubbard County,27, MN
26141,147,246,198,591,Presque Isle County,26, MI
31099,11,10,198,219,Kearney County,31, NE
13057,215,50,198,463,Cherokee County,13, GA
21061,172,177,198,547,Edmonson County,21, KY
37199,202,131,199,532,Yancey County,37, NC
5021,34,101,199,334,Clay County,5, AR
30057,232,58,199,489,Madison County,30, MT
49011,248,27,199,474,Davis County,49, UT
23019,105,73,199,377,Penobscot County,23, ME
31053,104,14,199,317,Dodge County,31, NE
51133,195,116,199,510,Northumberland County,51, VA
13103,130,54,199,383,Effingham County,13, GA
51115,192,50,199,441,Mathews County,51, VA
41031,245,197,199,641,Jefferson County,41, OR
21155,67,181,199,447,Marion County,21, KY
51163,174,78,199,451,Rockbridge County,51, VA
55131,24,83,200,307,Washington County,55, WI
48289,158,181,200,539,Leon County,48, TX
48385,235,135,200,570,Real County,48, TX
51137,86,83,200,369,Orange County,51, VA
19101,11,87,200,298,Jefferson County,19, IA
31033,53,33,200,286,Cheyenne County,31, NE
21125,197,144,200,541,Laurel County,21, KY
20137,208,4,200,412,Norton County,20, KS
55115,10,120,200,330,Shawano County,55, WI
51610,67,20,200,287,Falls Church city,51, VA
48243,250,58,200,508,Jeff Davis County,48, TX
51071,142,116,200,458,Giles County,51, VA
39079,68,212,201,481,Jackson County,39, OH
26093,49,215,201,465,Livingston County,26, MI
39039,24,197,201,422,Defiance County,39, OH
8087,204,73,201,478,Morgan County,8, CO
51023,193,37,201,431,Botetourt County,51, VA
31081,20,18,201,239,Hamilton County,31, NE
46047,214,101,201,516,Fall River County,46, SD
51600,67,83,201,351,Fairfax city,51, VA
53043,170,140,201,511,Lincoln County,53, WA
48125,160,116,201,477,Dickens County,48, TX
39115,154,225,201,580,Morgan County,39, OH
27155,8,33,201,242,Traverse County,27, MN
51035,175,197,202,574,Carroll County,51, VA
51101,132,73,202,407,King William County,51, VA
40063,133,170,202,505,Hughes County,40, OK
39173,20,153,202,375,Wood County,39, OH
21225,177,116,202,495,Union County,21, KY
39021,33,153,202,388,Champaign County,39, OH
31101,206,10,202,418,Keith County,31, NE
21031,132,144,202,478,Butler County,21, KY
51149,153,126,202,481,Prince George County,51, VA
38077,5,22,202,229,Richland County,38, ND
47007,103,209,202,514,Bledsoe County,47, TN
21139,178,170,202,550,Livingston County,21, KY
13117,188,40,203,431,Forsyth County,13, GA
39105,13,231,203,447,Meigs County,39, OH
27055,59,31,203,293,Houston County,27, MN
31119,104,22,203,329,Madison County,31, NE
39009,136,162,203,501,Athens County,39, OH
36051,85,153,203,441,Livingston County,36, NY
39165,76,120,203,399,Warren County,39, OH
19109,1,20,203,224,Kossuth County,19, IA
19005,120,58,203,381,Allamakee County,19, IA
17175,5,162,203,370,Stark County,17, IL
18137,30,120,203,353,Ripley County,18, IN
51107,99,67,203,369,Loudoun County,51, VA
23003,127,78,204,409,Aroostook County,23, ME
51036,171,126,204,501,Charles City County,51, VA
16007,236,29,204,469,Bear Lake County,16, ID
38055,64,37,204,305,McLean County,38, ND
13169,187,40,204,431,Jones County,13, GA
51051,171,190,204,565,Dickenson County,51, VA
46107,65,10,204,279,Potter County,46, SD
56011,225,22,204,451,Crook County,56, WY
39103,14,174,204,392,Medina County,39, OH
13291,229,33,204,466,Union County,13, GA
48107,224,63,204,491,Crosby County,48, TX
51113,92,20,205,317,Madison County,51, VA
44001,202,174,205,581,Bristol County,44, RI
48065,195,29,205,429,Carson County,48, TX
39097,16,96,205,317,Madison County,39, OH
28121,146,67,205,418,Rankin County,28, MS
8035,246,91,205,542,Douglas County,8, CO
36109,119,110,205,434,Tompkins County,36, NY
39133,38,162,205,405,Portage County,39, OH
31125,110,10,205,325,Nance County,31, NE
20143,54,31,205,290,Ottawa County,20, KS
30099,238,33,205,476,Teton County,30, MT
18139,4,116,205,325,Rush County,18, IN
48431,153,120,206,479,Sterling County,48, TX
27169,56,50,206,312,Winona County,27, MN
53055,241,186,206,633,San Juan County,53, WA
51061,59,43,206,308,Fauquier County,51, VA
55091,95,96,206,397,Pepin County,55, WI
36053,83,181,206,470,Madison County,36, NY
5025,57,106,206,369,Cleveland County,5, AR
49039,241,18,206,465,Sanpete County,49, UT
27005,33,110,206,349,Becker County,27, MN
31105,131,14,206,351,Kimball County,31, NE
9007,222,126,206,554,Middlesex County,9, CT
21095,159,249,206,614,Harlan County,21, KY
41015,251,212,207,670,Curry County,41, OR
5109,193,96,207,496,Pike County,5, AR
29163,165,78,207,450,Pike County,29, MO
29003,79,24,207,310,Andrew County,29, MO
51157,88,37,207,332,Rappahannock County,51, VA
18009,12,190,207,409,Blackford County,18, IN
16065,185,4,207,396,Madison County,16, ID
34041,186,207,207,600,Warren County,34, NJ
39051,12,186,207,405,Fulton County,39, OH
27025,37,131,207,375,Chisago County,27, MN
48173,150,16,207,373,Glasscock County,48, TX
50015,89,181,207,477,Lamoille County,50, VT
51059,67,91,208,366,Fairfax County,51, VA
55099,23,140,208,371,Price County,55, WI
36123,135,126,208,469,Yates County,36, NY
39033,6,227,208,441,Crawford County,39, OH
42047,141,250,208,599,Elk County,42, PA
46063,98,16,208,322,Harding County,46, SD
27029,17,227,208,452,Clearwater County,27, MN
48171,225,46,208,479,Gillespie County,48, TX
13141,206,215,208,629,Hancock County,13, GA
19043,79,87,208,374,Clayton County,19, IA
18101,125,29,208,362,Martin County,18, IN
17101,33,212,208,453,Lawrence County,17, IL
29173,72,37,209,318,Ralls County,29, MO
13113,121,73,209,403,Fayette County,13, GA
39025,132,144,209,485,Clermont County,39, OH
48035,182,78,209,469,Bosque County,48, TX
37149,213,110,209,532,Polk County,37, NC
8113,246,245,209,700,San Miguel County,8, CO
18111,10,144,209,363,Newton County,18, IN
16041,210,16,209,435,Franklin County,16, ID
28131,74,170,209,453,Stone County,28, MS
20071,49,0,209,258,Greeley County,20, KS
27033,33,40,209,282,Cottonwood County,27, MN
27135,2,87,209,298,Roseau County,27, MN
39161,7,149,210,366,Van Wert County,39, OH
46093,54,50,210,314,Meade County,46, SD
31169,15,4,210,229,Thayer County,31, NE
20163,83,24,210,317,Rooks County,20, KS
55027,48,67,210,325,Dodge County,55, WI
55041,25,250,210,485,Forest County,55, WI
23009,214,87,210,511,Hancock County,23, ME
54029,161,237,210,608,Hancock County,54, WV
51165,197,43,210,450,Rockingham County,51, VA
23013,218,73,210,501,Knox County,23, ME
19189,5,120,210,335,Winnebago County,19, IA
21121,60,197,210,467,Knox County,21, KY
42041,102,135,211,448,Cumberland County,42, PA
39041,56,67,211,334,Delaware County,39, OH
30001,235,24,211,470,Beaverhead County,30, MT
48435,205,234,211,650,Sutton County,48, TX
26119,84,252,211,547,Montmorency County,26, MI
19077,72,54,211,337,Guthrie County,19, IA
51530,174,87,211,472,Buena Vista city,51, VA
28095,183,218,211,612,Monroe County,28, MS
18021,25,131,211,367,Clay County,18, IN
26019,178,227,211,616,Benzie County,26, MI
49015,181,43,211,435,Emery County,49, UT
38009,9,73,211,293,Bottineau County,38, ND
53069,232,215,212,659,Wahkiakum County,53, WA
31041,64,4,212,280,Custer County,31, NE
18061,91,116,212,419,Harrison County,18, IN
51075,77,50,212,339,Goochland County,51, VA
18049,14,131,212,357,Fulton County,18, IN
31157,192,29,212,433,Scotts Bluff County,31, NE
27121,28,37,212,277,Pope County,27, MN
27097,15,140,212,367,Morrison County,27, MN
28135,84,166,212,462,Tallahatchie County,28, MS
55045,34,46,212,292,Green County,55, WI
21231,184,126,212,522,Wayne County,21, KY
29061,41,29,212,282,Daviess County,29, MO
21147,178,162,213,553,McCreary County,21, KY
39169,13,96,213,322,Wayne County,39, OH
51103,201,158,213,572,Lancaster County,51, VA
55029,127,140,213,480,Door County,55, WI
21087,6,73,213,292,Green County,21, KY
49049,244,18,213,475,Utah County,49, UT
39117,23,153,213,389,Morrow County,39, OH
42119,76,140,213,429,Union County,42, PA
19141,2,13,213,228,O'Brien County,19, IA
21181,63,140,213,416,Nicholas County,21, KY
31141,101,18,213,332,Platte County,31, NE
27101,37,58,213,308,Murray County,27, MN
34027,199,181,214,594,Morris County,34, NJ
36049,21,177,214,412,Lewis County,36, NY
56045,85,22,214,321,Weston County,56, WY
41007,245,231,214,690,Clatsop County,41, OR
39073,97,166,214,477,Hocking County,39, OH
31087,82,14,214,310,Hitchcock County,31, NE
46039,53,73,214,340,Deuel County,46, SD
39083,18,110,214,342,Knox County,39, OH
27173,4,40,214,258,Yellow Medicine County,27, MN
17075,3,110,214,327,Iroquois County,17, IL
8125,155,6,214,375,Yuma County,8, CO
21129,169,149,214,532,Lee County,21, KY
29197,46,87,215,348,Schuyler County,29, MO
55109,66,153,215,434,St. Croix County,55, WI
42067,115,158,215,488,Juniata County,42, PA
18033,20,144,215,379,DeKalb County,18, IN
39167,148,209,215,572,Washington County,39, OH
31135,36,0,215,251,Perkins County,31, NE
18087,32,120,215,367,LaGrange County,18, IN
36091,143,135,215,493,Saratoga County,36, NY
19051,44,24,215,283,Davis County,19, IA
21115,174,212,215,601,Johnson County,21, KY
19009,45,13,215,273,Audubon County,19, IA
31129,48,4,215,267,Nuckolls County,31, NE
27163,99,83,216,398,Washington County,27, MN
55121,63,149,216,428,Trempealeau County,55, WI
39001,48,223,216,487,Adams County,39, OH
22005,71,135,216,422,Ascension Parish,22, LA
17139,44,54,216,314,Moultrie County,17, IL
46057,66,14,216,296,Hamlin County,46, SD
54071,181,50,216,447,Pendleton County,54, WV
19001,57,24,216,297,Adair County,19, IA
16051,203,13,216,432,Jefferson County,16, ID
9005,189,144,216,549,Litchfield County,9, CT
34035,62,181,216,459,Somerset County,34, NJ
28141,209,126,216,551,Tishomingo County,28, MS
40151,74,13,217,304,Woods County,40, OK
26061,101,158,217,476,Houghton County,26, MI
39005,19,126,217,362,Ashland County,39, OH
55077,36,135,217,388,Marquette County,55, WI
29151,162,16,217,395,Osage County,29, MO
17063,40,215,217,472,Grundy County,17, IL
13061,201,250,217,668,Clay County,13, GA
36107,77,181,217,475,Tioga County,36, NY
5059,166,91,217,474,Hot Spring County,5, AR
18059,7,83,217,307,Hancock County,18, IN
51065,106,67,217,390,Fluvanna County,51, VA
28051,84,254,217,555,Holmes County,28, MS
21163,179,153,218,550,Meade County,21, KY
51119,198,58,218,474,Middlesex County,51, VA
19075,1,33,218,252,Grundy County,19, IA
19037,7,43,218,268,Chickasaw County,19, IA
39109,33,149,218,400,Miami County,39, OH
18015,20,101,218,339,Carroll County,18, IN
2170,0,201,218,419,Matanuska-Susitna Borough,2, AK
39067,136,223,218,577,Harrison County,39, OH
21205,187,170,218,575,Rowan County,21, KY
47127,159,73,218,450,Moore County,47, TN
39131,91,227,218,536,Pike County,39, OH
28081,87,194,218,499,Lee County,28, MS
21105,88,78,219,385,Hickman County,21, KY
27171,27,78,219,324,Wright County,27, MN
27019,22,63,219,304,Carver County,27, MN
13267,169,31,219,419,Tattnall County,13, GA
48447,91,50,219,360,Throckmorton County,48, TX
21045,44,110,219,373,Casey County,21, KY
9015,198,181,219,598,Windham County,9, CT
28005,79,205,219,503,Amite County,28, MS
5101,120,54,219,393,Newton County,5, AR
31003,27,2,219,248,Antelope County,31, NE
55133,40,83,219,342,Waukesha County,55, WI
13231,99,54,219,372,Pike County,13, GA
18037,115,37,220,372,Dubois County,18, IN
44009,226,181,220,627,Washington County,44, RI
29199,58,11,220,289,Scotland County,29, MO
17039,26,126,220,372,De Witt County,17, IL
31021,51,22,220,293,Burt County,31, NE
13189,216,181,220,617,McDuffie County,13, GA
48229,239,190,220,649,Hudspeth County,48, TX
28155,117,166,220,503,Webster County,28, MS
56023,246,54,220,520,Lincoln County,56, WY
21027,158,162,220,540,Breckinridge County,21, KY
50001,119,54,220,393,Addison County,50, VT
36095,118,153,220,491,Schoharie County,36, NY
13283,138,101,221,460,Treutlen County,13, GA
19159,46,22,221,289,Ringgold County,19, IA
21079,70,116,221,407,Garrard County,21, KY
29111,111,50,221,382,Lewis County,29, MO
56043,191,67,221,479,Washakie County,56, WY
46033,187,101,221,509,Custer County,46, SD
21057,174,50,221,445,Cumberland County,21, KY
51025,62,190,221,473,Brunswick County,51, VA
18113,45,205,221,471,Noble County,18, IN
50017,102,46,221,369,Orange County,50, VT
46061,10,63,221,294,Hanson County,46, SD
17203,35,106,221,362,Woodford County,17, IL
30055,168,7,222,397,McCone County,30, MT
27063,42,46,222,310,Jackson County,27, MN
16081,214,87,222,523,Teton County,16, ID
31097,24,22,222,268,Johnson County,31, NE
18121,34,78,222,334,Parke County,18, IN
55047,57,144,222,423,Green Lake County,55, WI
49023,214,7,222,443,Juab County,49, UT
51063,77,58,222,357,Floyd County,51, VA
48425,194,126,222,542,Somervell County,48, TX
34037,199,227,222,648,Sussex County,34, NJ
23023,190,43,222,455,Sagadahoc County,23, ME
28045,152,207,222,581,Hancock County,28, MS
39065,8,194,223,425,Hardin County,39, OH
13073,180,29,223,432,Columbia County,13, GA
21127,125,201,223,549,Lawrence County,21, KY
21215,161,91,223,475,Spencer County,21, KY
21207,201,197,223,621,Russell County,21, KY
21197,68,162,223,453,Powell County,21, KY
41025,234,96,223,553,Harney County,41, OR
51019,203,58,223,484,Bedford County,51, VA
31153,42,27,223,292,Sarpy County,31, NE
19085,77,24,223,324,Harrison County,19, IA
28029,76,201,223,500,Copiah County,28, MS
41057,248,194,223,665,Tillamook County,41, OR
5073,101,174,224,499,Lafayette County,5, AR
21005,108,106,224,438,Anderson County,21, KY
54035,131,209,224,564,Jackson County,54, WV
29063,33,31,224,288,DeKalb County,29, MO
22043,124,126,224,474,Grant Parish,22, LA
39031,98,218,224,540,Coshocton County,39, OH
38073,2,27,224,253,Ransom County,38, ND
28139,72,149,224,445,Tippah County,28, MS
18029,42,144,224,410,Dearborn County,18, IN
19081,3,43,224,270,Hancock County,19, IA
8015,251,116,224,591,Chaffee County,8, CO
21055,165,78,224,467,Crittenden County,21, KY
55089,112,73,225,410,Ozaukee County,55, WI
23027,148,63,225,436,Waldo County,23, ME
38065,38,63,225,326,Oliver County,38, ND
51145,48,46,225,319,Powhatan County,51, VA
48137,231,14,225,470,Edwards County,48, TX
46087,16,18,225,259,McCook County,46, SD
54091,136,166,225,527,Taylor County,54, WV
55075,38,181,225,444,Marinette County,55, WI
27045,18,54,225,297,Fillmore County,27, MN
28073,120,101,225,446,Lamar County,28, MS
18083,44,96,225,365,Knox County,18, IN
28109,85,162,225,472,Pearl River County,28, MS
21081,84,153,226,463,Grant County,21, KY
39027,41,201,226,468,Clinton County,39, OH
49005,226,7,226,459,Cache County,49, UT
19149,22,16,226,264,Plymouth County,19, IA
18017,16,140,226,382,Cass County,18, IN
39125,23,170,226,419,Paulding County,39, OH
18055,92,110,226,428,Greene County,18, IN
18153,41,149,226,416,Sullivan County,18, IN
28039,90,221,226,537,George County,28, MS
31049,100,8,226,334,Deuel County,31, NE
39107,47,73,226,346,Mercer County,39, OH
41021,164,106,226,496,Gilliam County,41, OR
48011,158,31,227,416,Armstrong County,48, TX
28079,177,186,227,590,Leake County,28, MS
16061,188,177,227,592,Lewis County,16, ID
13259,137,87,227,451,Stewart County,13, GA
38091,8,8,227,243,Steele County,38, ND
27077,15,106,227,348,Lake of the Woods County,27, MN
31073,76,3,227,306,Gosper County,31, NE
19011,6,54,227,287,Benton County,19, IA
21229,101,110,227,438,Washington County,21, KY
8014,0,131,227,358,Broomfield County,8, CO
31185,3,13,227,243,York County,31, NE
21123,71,158,227,456,Larue County,21, KY
27059,23,140,228,391,Isanti County,27, MN
51143,118,126,228,472,Pittsylvania County,51, VA
55123,97,63,228,388,Vernon County,55, WI
8033,241,144,228,613,Dolores County,8, CO
21137,69,186,228,483,Lincoln County,21, KY
31147,46,10,228,284,Richardson County,31, NE
29103,61,24,228,313,Knox County,29, MO
39157,116,174,228,518,Tuscarawas County,39, OH
13085,224,43,228,495,Dawson County,13, GA
19107,4,50,228,282,Keokuk County,19, IA
21177,148,212,228,588,Muhlenberg County,21, KY
21185,88,46,228,362,Oldham County,21, KY
38045,11,3,229,243,LaMoure County,38, ND
39171,17,181,229,427,Williams County,39, OH
21043,144,231,229,604,Carter County,21, KY
18171,12,73,229,314,Warren County,18, IN
21023,167,110,229,506,Bracken County,21, KY
39013,144,237,229,610,Belmont County,39, OH
18025,124,153,229,506,Crawford County,18, IN
17015,131,158,229,518,Carroll County,17, IL
31159,13,27,229,269,Seward County,31, NE
40067,199,135,229,563,Jefferson County,40, OK
51009,181,83,229,493,Amherst County,51, VA
21089,172,218,229,619,Greenup County,21, KY
27075,151,162,230,543,Lake County,27, MN
8039,184,43,230,457,Elbert County,8, CO
21153,54,254,230,538,Magoffin County,21, KY
55078,10,254,230,494,Menominee County,55, WI
13197,87,58,230,375,Marion County,13, GA
48299,237,87,230,554,Llano County,48, TX
18123,112,126,230,468,Perry County,18, IN
31027,43,4,230,277,Cedar County,31, NE
18109,86,73,230,389,Morgan County,18, IN
40073,92,31,230,353,Kingfisher County,40, OK
56031,239,54,230,523,Platte County,56, WY
39081,92,237,230,559,Jefferson County,39, OH
20187,57,2,231,290,Stanton County,20, KS
21223,156,140,231,527,Trimble County,21, KY
18133,22,110,231,363,Putnam County,18, IN
17173,33,120,231,384,Shelby County,17, IL
51091,155,18,231,404,Highland County,51, VA
38069,22,31,231,284,Pierce County,38, ND
18073,8,149,231,388,Jasper County,18, IN
17133,132,83,231,446,Monroe County,17, IL
18145,5,153,231,389,Shelby County,18, IN
27069,1,40,231,272,Kittson County,27, MN
40053,79,11,231,321,Grant County,40, OK
39137,6,83,231,320,Putnam County,39, OH
48109,236,126,232,594,Culberson County,48, TX
17141,20,194,232,446,Ogle County,17, IL
55061,146,40,232,418,Kewaunee County,55, WI
18151,56,110,232,398,Steuben County,18, IN
38005,15,140,232,387,Benson County,38, ND
21135,179,229,232,640,Lewis County,21, KY
38013,41,67,232,340,Burke County,38, ND
51017,219,236,232,687,Bath County,51, VA
27079,38,140,232,410,Le Sueur County,27, MN
21099,132,120,232,484,Hart County,21, KY
18147,37,83,232,352,Spencer County,18, IN
50013,126,96,232,454,Grand Isle County,50, VT
46097,9,46,233,288,Miner County,46, SD
18065,24,131,233,388,Henry County,18, IN
5147,61,91,233,385,Woodruff County,5, AR
21149,59,83,233,375,McLean County,21, KY
18183,25,96,233,354,Whitley County,18, IN
46067,11,20,233,264,Hutchinson County,46, SD
27157,74,67,233,374,Wabasha County,27, MN
46049,34,14,233,281,Faulk County,46, SD
22039,103,177,233,513,Evangeline Parish,22, LA
49051,244,120,233,597,Wasatch County,49, UT
38027,28,43,233,304,Eddy County,38, ND
46079,47,20,233,300,Lake County,46, SD
21071,139,223,234,596,Floyd County,21, KY
19059,60,58,234,352,Dickinson County,19, IA
36079,159,174,234,567,Putnam County,36, NY
20115,90,27,234,351,Marion County,20, KS
31123,209,16,234,459,Morrill County,31, NE
22107,107,205,234,546,Tensas Parish,22, LA
55141,29,135,234,398,Wood County,55, WI
46127,50,58,234,342,Union County,46, SD
16087,219,73,234,526,Washington County,16, ID
19047,46,63,234,343,Crawford County,19, IA
39175,13,149,234,396,Wyandot County,39, OH
21039,79,43,234,356,Carlisle County,21, KY
20097,41,11,235,287,Kiowa County,20, KS
54073,128,246,235,609,Pleasants County,54, WV
27129,4,78,235,317,Renville County,27, MN
21003,60,78,235,373,Allen County,21, KY
39147,10,194,235,439,Seneca County,39, OH
21063,154,237,235,626,Elliott County,21, KY
18129,59,50,235,344,Posey County,18, IN
39011,12,144,235,391,Auglaize County,39, OH
28069,101,231,235,567,Kemper County,28, MS
19121,39,87,235,361,Madison County,19, IA
19027,52,24,235,311,Carroll County,19, IA
27031,230,205,235,670,Cook County,27, MN
38075,22,50,236,308,Renville County,38, ND
26043,7,149,236,392,Dickinson County,26, MI
48077,114,78,236,428,Clay County,48, TX
19019,13,40,236,289,Buchanan County,19, IA
48247,79,229,236,544,Jim Hogg County,48, TX
32017,238,58,236,532,Lincoln County,32, NV
21133,94,239,236,569,Letcher County,21, KY
31131,32,14,236,282,Otoe County,31, NE
21195,125,205,236,566,Pike County,21, KY
21171,130,73,236,439,Monroe County,21, KY
19131,2,13,236,251,Mitchell County,19, IA
17025,16,227,236,479,Clay County,17, IL
39029,121,227,237,585,Columbiana County,39, OH
13307,104,87,237,428,Webster County,13, GA
34019,181,158,237,576,Hunterdon County,34, NJ
49055,185,174,237,596,Wayne County,49, UT
19041,26,37,237,300,Clay County,19, IA
8021,245,83,237,565,Conejos County,8, CO
39055,28,135,237,400,Geauga County,39, OH
31023,10,13,237,260,Butler County,31, NE
21203,114,153,237,504,Rockcastle County,21, KY
46041,172,177,237,586,Dewey County,46, SD
55065,59,31,237,327,Lafayette County,55, WI
9013,205,110,237,552,Tolland County,9, CT
20201,17,3,238,258,Washington County,20, KS
21143,206,67,238,511,Lyon County,21, KY
46137,104,46,238,388,Ziebach County,46, SD
8049,253,205,238,696,Grand County,8, CO
18047,62,96,238,396,Franklin County,18, IN
18011,6,31,238,275,Boone County,18, IN
31177,33,18,238,289,Washington County,31, NE
21091,166,106,238,510,Hancock County,21, KY
17155,59,201,238,498,Putnam County,17, IL
21069,87,162,238,487,Fleming County,21, KY
20189,72,7,238,317,Stevens County,20, KS
55119,10,50,238,298,Taylor County,55, WI
19105,9,87,239,335,Jones County,19, IA
20047,16,8,239,263,Edwards County,20, KS
38049,12,78,239,329,McHenry County,38, ND
18057,26,43,239,308,Hamilton County,18, IN
28053,72,253,239,564,Humphreys County,28, MS
31155,24,18,239,281,Saunders County,31, NE
13209,141,73,239,453,Montgomery County,13, GA
56041,233,116,239,588,Uinta County,56, WY
51011,96,91,239,426,Appomattox County,51, VA
55125,57,158,239,454,Vilas County,55, WI
54097,59,231,239,529,Upshur County,54, WV
31061,58,14,239,311,Franklin County,31, NE
31179,3,6,240,249,Wayne County,31, NE
27089,3,126,240,369,Marshall County,27, MN
51775,137,91,240,468,Salem city,51, VA
39123,64,221,240,525,Ottawa County,39, OH
19089,2,37,240,279,Howard County,19, IA
48413,142,144,240,526,Schleicher County,48, TX
19091,3,29,240,272,Humboldt County,19, IA
39077,15,229,240,484,Huron County,39, OH
39127,148,205,240,593,Perry County,39, OH
46011,41,33,240,314,Brookings County,46, SD
19025,21,27,240,288,Calhoun County,19, IA
21233,34,120,240,394,Webster County,21, KY
48461,189,83,241,513,Upton County,48, TX
22023,179,87,241,507,Cameron Parish,22, LA
48417,130,67,241,438,Shackelford County,48, TX
37103,57,91,241,389,Jones County,37, NC
41063,227,153,241,621,Wallowa County,41, OR
31089,54,2,241,297,Holt County,31, NE
17005,43,140,241,424,Bond County,17, IL
19191,1,50,241,292,Winneshiek County,19, IA
18155,124,194,241,559,Switzerland County,18, IN
27073,10,43,241,294,Lac qui Parle County,27, MN
5121,117,96,241,454,Randolph County,5, AR
55103,68,58,241,367,Richland County,55, WI
31139,25,11,242,278,Pierce County,31, NE
48383,171,233,242,646,Reagan County,48, TX
21065,170,170,242,582,Estill County,21, KY
21237,80,177,242,499,Wolfe County,21, KY
39111,123,242,242,607,Monroe County,39, OH
31181,47,20,242,309,Webster County,31, NE
29129,70,16,242,328,Mercer County,29, MO
20183,83,4,242,329,Smith County,20, KS
16003,238,225,242,705,Adams County,16, ID
21103,108,87,242,437,Henry County,21, KY
28071,167,106,242,515,Lafayette County,28, MS
18179,5,87,242,334,Wells County,18, IN
17149,47,101,243,391,Pike County,17, IL
39159,8,91,243,342,Union County,39, OH
38097,0,16,243,259,Traill County,38, ND
48319,207,83,243,533,Mason County,48, TX
46031,95,54,243,392,Corson County,46, SD
18045,22,126,243,391,Fountain County,18, IN
27015,16,58,243,317,Brown County,27, MN
16037,183,54,243,480,Custer County,16, ID
18135,6,131,243,380,Randolph County,18, IN
30061,212,239,243,694,Mineral County,30, MT
16071,146,29,243,418,Oneida County,16, ID
18001,8,83,243,334,Adams County,18, IN
26089,178,190,244,612,Leelanau County,26, MI
8095,95,4,244,343,Phillips County,8, CO
21175,161,144,244,549,Morgan County,21, KY
21109,89,212,244,545,Jackson County,21, KY
31039,92,3,244,339,Cuming County,31, NE
8091,250,194,244,688,Ouray County,8, CO
19073,31,29,244,304,Greene County,19, IA
28145,88,153,244,485,Union County,28, MS
27117,2,24,244,270,Pipestone County,27, MN
21189,54,166,244,464,Owsley County,21, KY
55083,45,116,244,405,Oconto County,55, WI
28041,138,233,244,615,Greene County,28, MS
36041,151,186,245,582,Hamilton County,36, NY
48333,109,27,245,381,Mills County,48, TX
22037,61,135,245,441,East Feliciana Parish,22, LA
21169,14,181,245,440,Metcalfe County,21, KY
21053,172,58,245,475,Clinton County,21, KY
49029,237,11,245,493,Morgan County,49, UT
38021,17,11,245,273,Dickey County,38, ND
18119,92,116,245,453,Owen County,18, IN
21119,141,207,245,593,Knott County,21, KY
21187,98,120,245,463,Owen County,21, KY
39075,82,22,245,349,Holmes County,39, OH
37005,205,162,245,612,Alleghany County,37, NC
21131,110,244,246,600,Leslie County,21, KY
39015,131,197,246,574,Brown County,39, OH
28111,119,212,246,577,Perry County,28, MS
31167,100,13,246,359,Stanton County,31, NE
40033,184,149,246,579,Cotton County,40, OK
19173,62,18,246,326,Taylor County,19, IA
21165,165,218,246,629,Menifee County,21, KY
17129,16,120,246,382,Menard County,17, IL
19185,46,37,246,329,Wayne County,19, IA
55011,72,166,246,484,Buffalo County,55, WI
51021,88,83,246,417,Bland County,51, VA
21025,66,239,246,551,Breathitt County,21, KY
51678,174,149,247,570,Lexington city,51, VA
48377,230,253,247,730,Presidio County,48, TX
41023,163,201,247,611,Grant County,41, OR
38079,37,252,247,536,Rolette County,38, ND
18013,119,135,247,501,Brown County,18, IN
37121,207,181,247,635,Mitchell County,37, NC
18169,42,106,247,395,Wabash County,18, IN
19053,42,20,247,309,Decatur County,19, IA
55023,104,162,247,513,Crawford County,55, WI
31107,67,8,247,322,Knox County,31, NE
51159,174,50,247,471,Richmond County,51, VA
29085,196,58,247,501,Hickory County,29, MO
17067,55,144,248,447,Hancock County,17, IL
18077,86,166,248,500,Jefferson County,18, IN
19165,43,16,248,307,Shelby County,19, IA
21011,156,201,248,605,Bath County,21, KY
17007,11,246,248,505,Boone County,17, IL
48351,204,245,248,697,Newton County,48, TX
41001,223,158,248,629,Baker County,41, OR
28061,75,218,248,541,Jasper County,28, MS
18041,11,236,248,495,Fayette County,18, IN
46055,118,3,255,376,Haakon County,46, SD
46037,71,87,255,413,Day County,46, SD
2290,0,250,255,505,Yukon-Koyukuk Census Area,2, AK
38011,79,13,255,347,Bowman County,38, ND
31075,131,1,255,387,Grant County,31, NE
27143,15,78,255,348,Sibley County,27, MN
31015,23,6,255,284,Boyd County,31, NE
37075,231,236,255,722,Graham County,37, NC
38085,82,22,255,359,Sioux County,38, ND
21201,46,106,255,407,Robertson County,21, KY
30051,164,6,255,425,Liberty County,30, MT
28119,44,245,255,544,Quitman County,28, MS
2270,0,0,255,255,Wade Hampton Census Area,2, AK
37095,205,239,255,699,Hyde County,37, NC
46043,7,8,255,270,Douglas County,46, SD
31171,56,24,255,335,Thomas County,31, NE
31175,132,6,255,393,Valley County,31, NE
30069,213,13,255,481,Petroleum County,30, MT
46077,45,18,255,318,Kingsbury County,46, SD
46069,31,9,255,295,Hyde County,46, SD
1105,182,245,255,682,Perry County,1, AL
46113,130,0,255,385,Shannon County,46, SD
46075,61,18,255,334,Jones County,46, SD
46051,27,24,255,306,Grant County,46, SD
2282,0,207,255,462,Yakutat City and Borough,2, AK
46085,68,87,255,410,Lyman County,46, SD
31165,97,2,255,354,Sioux County,31, NE
28129,70,91,255,416,Smith County,28, MS
48087,137,31,255,423,Collingsworth County,48, TX
2013,0,24,255,279,Aleutians East Borough,2, AK
2164,0,227,255,482,Lake and Peninsula Borough,2, AK
46053,98,20,255,373,Gregory County,46, SD
28023,162,205,255,622,Clarke County,28, MS
27107,0,116,255,371,Norman County,27, MN
39121,173,231,255,659,Noble County,39, OH
46017,57,190,255,502,Buffalo County,46, SD
28013,150,194,255,599,Calhoun County,28, MS
31083,110,7,255,372,Harlan County,31, NE
31077,101,7,255,363,Greeley County,31, NE
28009,78,201,255,534,Benton County,28, MS
30103,135,16,255,406,Treasure County,30, MT
37073,80,87,255,422,Gates County,37, NC
31071,63,1,255,319,Garfield County,31, NE
35033,247,190,255,692,Mora County,35, NM
31115,63,7,255,325,Loup County,31, NE
15005,0,0,255,255,Kalawao County,15, HI
49017,239,239,255,733,Garfield County,49, UT
19071,90,9,255,354,Fremont County,19, IA
22049,148,67,255,470,Jackson Parish,22, LA
28003,68,110,255,433,Alcorn County,28, MS
35021,198,31,255,484,Harding County,35, NM
31063,154,7,255,416,Frontier County,31, NE
31057,45,1,255,301,Dundy County,31, NE
31005,121,63,255,439,Arthur County,31, NE
31009,90,14,255,359,Blaine County,31, NE
31037,94,7,255,356,Colfax County,31, NE
20089,124,9,255,388,Jewell County,20, KS
28015,79,177,255,511,Carroll County,28, MS
31085,25,1,255,281,Hayes County,31, NE
31103,6,1,255,262,Keya Paha County,31, NE
31011,71,3,255,329,Boone County,31, NE
17059,125,223,255,603,Gallatin County,17, IL
30075,79,9,255,343,Powder River County,30, MT
48269,161,0,255,416,King County,48, TX
28153,91,212,255,558,Wayne County,28, MS
28125,67,245,255,567,Sharkey County,28, MS
28157,130,252,255,637,Wilkinson County,28, MS
13125,91,27,255,373,Glascock County,13, GA
31113,64,3,255,322,Logan County,31, NE
31035,10,10,255,275,Clay County,31, NE
28055,86,223,255,564,Issaquena County,28, MS
31093,155,33,255,443,Howard County,31, NE
28161,169,186,255,610,Yalobusha County,28, MS
31091,55,4,255,314,Hooker County,31, NE
13165,122,116,255,493,Jenkins County,13, GA
31117,85,4,255,344,McPherson County,31, NE
17013,93,174,255,522,Calhoun County,17, IL
17151,122,186,255,563,Pope County,17, IL
2240,0,166,255,421,Southeast Fairbanks Census Area,2, AK
20105,67,7,255,329,Lincoln County,20, KS
46111,9,27,255,291,Sanborn County,46, SD
5097,200,140,255,595,Montgomery County,5, AR
38029,49,54,255,358,Emmons County,38, ND
40059,168,11,255,434,Harper County,40, OK
38019,8,14,255,277,Cavalier County,38, ND
49009,241,37,255,533,Daggett County,49, UT
48345,122,40,255,417,Motley County,48, TX
49031,238,116,255,609,Piute County,49, UT
30025,67,24,255,346,Fallon County,30, MT
31163,153,10,255,418,Sherman County,31, NE
31133,27,6,255,288,Pawnee County,31, NE
13053,114,110,255,479,Chattahoochee County,13, GA
48081,237,78,255,570,Coke County,48, TX
38043,64,58,255,377,Kidder County,38, ND
38047,25,10,255,290,Logan County,38, ND
38081,7,33,255,295,Sargent County,38, ND
38007,92,18,255,365,Billings County,38, ND
46003,20,10,255,285,Aurora County,46, SD
38023,41,10,255,306,Divide County,38, ND
17171,28,131,255,414,Scott County,17, IL
20049,144,46,255,445,Elk County,20, KS
29171,85,33,255,373,Putnam County,29, MO
30039,221,197,255,673,Granite County,30, MT
48197,145,33,255,433,Hardeman County,48, TX
30101,187,54,255,496,Toole County,30, MT
28103,161,245,255,661,Noxubee County,28, MS
31121,35,24,255,314,Merrick County,31, NE
28117,91,149,255,495,Prentiss County,28, MS
48169,192,140,255,587,Garza County,48, TX
27011,21,43,255,319,Big Stone County,27, MN
28031,75,144,255,474,Covington County,28, MS
38083,46,101,255,402,Sheridan County,38, ND
31095,30,4,255,289,Jefferson County,31, NE
50009,79,126,255,460,Essex County,50, VT
13101,178,22,255,455,Echols County,13, GA
29075,50,13,255,318,Gentry County,29, MO
17065,17,135,255,407,Hamilton County,17, IL
31143,14,8,255,277,Polk County,31, NE
31017,75,4,255,334,Brown County,31, NE
19023,4,43,255,302,Butler County,19, IA
46025,35,22,255,312,Clark County,46, SD
48105,209,218,255,682,Crockett County,48, TX
48295,109,29,255,393,Lipscomb County,48, TX
46089,44,58,255,357,McPherson County,46, SD
27125,0,120,255,375,Red Lake County,27, MN
31183,42,0,255,297,Wheeler County,31, NE
38087,91,9,255,355,Slope County,38, ND
46009,57,27,255,339,Bon Homme County,46, SD
48301,233,0,255,488,Loving County,48, TX
30011,101,7,255,363,Carter County,30, MT
31007,93,3,255,351,Banner County,31, NE
31059,3,6,255,264,Fillmore County,31, NE
30033,174,4,255,433,Garfield County,30, MT
46119,148,6,255,409,Sully County,46, SD
8079,249,91,255,595,Mineral County,8, CO
46045,22,7,255,284,Edmunds County,46, SD
31069,219,14,255,488,Garden County,31, NE
31173,44,63,255,362,Thurston County,31, NE
18161,60,78,255,393,Union County,18, IN
46121,81,120,255,456,Todd County,46, SD
48271,237,101,255,593,Kinney County,48, TX
31065,55,6,255,316,Furnas County,31, NE
30109,90,58,255,403,Wibaux County,30, MT
38051,37,11,255,303,McIntosh County,38, ND
38001,49,20,255,324,Adams County,38, ND
19143,13,7,255,275,Osceola County,19, IA
48421,98,9,255,362,Sherman County,48, TX
46105,94,20,255,369,Perkins County,46, SD
8053,252,29,255,536,Hinsdale County,8, CO
46021,62,18,255,335,Campbell County,46, SD
38033,58,10,255,323,Golden Valley County,38, ND
16033,132,24,255,411,Clark County,16, ID
48045,211,46,255,512,Briscoe County,48, TX
38031,26,14,255,295,Foster County,38, ND
31013,135,46,255,436,Box Butte County,31, NE
48101,125,50,255,430,Cottle County,48, TX
18115,107,166,255,528,Ohio County,18, IN
28101,157,186,255,598,Newton County,28, MS
46073,18,3,255,276,Jerauld County,46, SD
40025,207,1,255,463,Cimarron County,40, OK
28077,131,212,255,598,Lawrence County,28, MS
2068,0,254,0,254,,2,
2105,0,252,0,252,,2,
2158,0,255,0,255,,2,
2195,0,212,0,212,,2,
2198,0,223,0,223,,2,
2230,0,255,0,255,,2,
2275,0,205,0,205,,2,
35013,243,201,0,444,,35,
46102,0,237,0,237,,46,
12025,248,0,0,248,,12,
30113,236,0,0,236,,30,
51560,212,0,0,212,,51,
51780,169,0,0,169,,51,
